番茄斑萎病毒病	病毒
暑湿热蕴证	疾病
四白汤	药物
肛乳头增生	疾病
醋酸氯已定溶液	药物
Dalvance	药物
肛周瘙痒	疾病
吡咯醇胺	疾病
参芪降糖片	药物
猪疥螨病	疾病
硬皮病	疾病
禽顶辐孢霉病	疾病
Sovaldi	药物
心因性精神障碍	症状
宫颈异常	疾病
马鼻疽	疾病
青春宝美容胶囊	药物
灵芝分散片	药物
阿娜尔妇洁液	病毒
口服砒霜	药物
禽脑脊髓炎	疾病
咽部瘢痕狭窄	疾病
二氧丙嗪片	药物
猪浆膜丝虫病	疾病
肝炎贴膏	药物
猪皮肤真菌病	疾病
金丝桃素	药物
囊性肾疾病	疾病
拉筋凳	药物
益肝灵胶囊	药物
风痛片	药物
舒泌通片	药物
百子附归丸	药物
通络生骨胶囊	症状
药物敷脐	药物
猪恶性水肿病	疾病
鸡白痢沙门氏菌	疾病
四乙基铅中毒	疾病
消化不良症候群	症状
越维咀嚼片	药物
利胆排石颗粒	药物
小儿增食片	药物
红线病	疾病
猪皮肤霉菌病	疾病
烂耳散	药物
鸡髓红细胞瘤	疾病
犬立克次氏体病	疾病
千舒消朦片	药物
性别畸形	疾病
突发性血小板减少	疾病
皮肤疣	疾病
喷昔洛韦软膏	药物
维脂康胶囊	药物
水乳梨醇	药物
梦行症	疾病
玉叶清火胶囊	药物
棘颚口线虫病	疾病
扎鲁司特	药物
参龙宁心胶囊	药物
保胎无忧胶囊	药物
寒湿痹片	药物
老烂腿	疾病
咽炎清丸	症状
代理蠕虫变种ZAH	病毒
GFAJ-1	细菌
哺乳期乳腺增生	疾病
高血压速降丸	药物
复方蟾酥膏	药物
茯苓白术散	药物
脱色性色素失禁症	疾病
白肌病	疾病
病毒性喉炎	疾病
复方珍珠暗疮胶囊	药物
净石灵片	药物
小儿病毒性脑炎	疾病
生殖器滴虫病	疾病
粘膜白斑	疾病
非霍金奇淋巴瘤	疾病
肝补片	药物
胃康宁片	药物
有机氯农药中毒	疾病
海带醋枣	药物
牛羊瘤胃膨气	症状
耶格综合症	疾病
肿块	疾病
脂蛋白肾小球病	疾病
濑野链霉菌	细菌
胰液素	药物
黄连上清丸	药物
前列桂黄片	药物
养生病	疾病
考试综合症	症状
胃苏冲剂	药物
T病毒	病毒
金牛眼药	疾病
活血壮筋胶囊	药物
回阳救逆	药物
孚来迪片	药物
三臣散	药物
毛囊角化	疾病
胃乐	药物
党参黄芪炖母鸡	疾病
嗜酸性粒细胞性膀胱炎	疾病
嗜酸粒细胞性肺浸润	疾病
疏风活络丸	药物
非酮性高甘胺酸血症	疾病
异丙铵	药物
UGG步	疾病
和肝利胆糖浆	药物
高热惊厥	疾病
重大疾病	疾病
纳减	症状
蜂胶片	药物
秋冬腹泻	疾病
六味消痔胶囊	药物
非洲马杜拉放线菌	细菌
眼睛皮肤白化症	疾病
孢子虫病	疾病
非甾体类抗炎药	药物
深圳幸福男科医院	疾病
二维呋喃唑酮片	药物
霉菌性鼻炎	疾病
鸭流感	疾病
复方氯解磷定注射液	药物
仙鹤叶散剂	疾病
强列参茸鞭丸	药物
益康升血肽	疾病
牛肺线虫病	疾病
腋力香	症状
过敏鼻炎	疾病
颅脑创伤	疾病
浸酒方	药物
银翘汤	疾病
症状性精神病	疾病
大豆黑痘病	疾病
无味奎宁	药物
排毒清脂片	药物
氯丙烯中毒	疾病
烟草环斑病毒病	疾病
温毒袭表证	疾病
川楝素	药物
子痰	疾病
增生性贫血	疾病
肛管湿疣	疾病
红棉散	药物
海洋巨型病毒	病毒
产蛋下降综合症	疾病
参燕百补戒烟丸	药物
引哒帕胺	药物
眼红	疾病
亚临床甲减	疾病
支气管肺发育不良	疾病
艾滋恐怖症	疾病
精神性早泄	疾病
浊邪上犯证	疾病
草莓潜环斑病毒	病毒
慢性放射病	疾病
血尿	症状
虹视	症状
梅迪-维斯纳病	疾病
苯乙酸睾丸素	药物
禽衣原体病	疾病
扁平颅底	症状
禽霍乱	疾病
梯洛龙	药物
黑变病	疾病
皂荚根皮	症状
多抗甲素口服液	症状
磷化氢中毒	疾病
血液病	疾病
假单胞菌	细菌
蘽根	症状
合萌叶	疾病
神经系统变性性疾病	疾病
百蕊胶囊	药物
铍病	疾病
太古菌	细菌
H5N1	病毒
丙米嗪片	药物
耶尔森氏菌病	疾病
乙酰甘氨酸乙二胺	药物
十味黑冰片丸	药物
鸡滑液囊支原体病	疾病
前列腺炎综合症	症状
猪锌缺乏症	疾病
湿肺	疾病
甘黄蒲苓汤	药物
泰道	药物
盘卷诺卡氏菌	细菌
结核性巩膜炎	疾病
多发性骨软骨瘤	疾病
物欲症	疾病
铬（营养）片	药物
感冒清片	药物
散疹茶	药物
囊性肿瘤	疾病
泊利噻嗪	药物
甲型H3N2流感	疾病
淀粉酶链霉菌	细菌
巴戟天寡糖胶囊	药物
维生素B6缺乏症	疾病
新安替根	药物
小金旦	药物
优品宫巢双修膏	疾病
滴比露	疾病
口腔健康	疾病
猪胃虫病	疾病
慢性肝炎	病毒
息百虑	药物
猪结肠小袋虫病	疾病
产金菌门	细菌
非结核分枝杆菌肺病	疾病
鸡葡萄球菌病	疾病
猫白血病	疾病
倒扎龙	症状
肺良性淋巴细胞血管炎	疾病
双休综合征	疾病
OU-20细菌	细菌
鱼鳞汤	疾病
伤湿解痛膏	药物
紫红链霉菌	细菌
小儿肺炎散	药物
死亡恐怖症	疾病
阿根廷出血热	疾病
六味香连胶囊	药物
绿脓杆菌性肺炎	疾病
丹桂香胶囊	药物
网银小燕	病毒
猪锰缺乏症	疾病
猫肠道冠状病毒病	疾病
化脓性血栓性静脉炎	疾病
寄生胎	疾病
痤疮膏	药物
官场心病	疾病
人流感	疾病
原圆线虫病	疾病
强力安喘通	药物
乙型流感病毒	疾病
猪土拉杆菌病	疾病
牛羊血吸虫病	疾病
火鸡鼻气管炎	疾病
血脂康片	药物
航空病	疾病
心肌疾病	疾病
月经病	疾病
复方磺胺甲恶唑分散片	疾病
跳骨片	药物
胃可舒	药物
盐酸吗啉双胍	药物
茵白肝炎冲剂	药物
胸腺发育不全	疾病
孚琪乳膏	药物
产水菌门	细菌
双奎呱	药物
莫地卡尼	药物
醒脾胶囊	药物
猪腺病毒感染	疾病
剥脱性皮炎	疾病
山冬茶	药物
西尼罗病毒病	疾病
狗瘟热	疾病
Lowe氏症候群	疾病
耳鼻喉科学	医学专科
耳闭症	疾病
环戊噻嗪	疾病
络瘀通胶囊	药物
高山心脏病	疾病
胸腔外科学	医学专科
肢端雀斑样黑素瘤	疾病
外源性抑郁症	疾病
妊娠舞蹈病	疾病
调经活血胶囊	药物
调经祛斑片	药物
猪维生素B1缺乏症	疾病
鸡结核病	疾病
嗜睡	疾病
肛门出血	疾病
猪有机磷中毒	疾病
血小板疾病	疾病
胃粘膜素	药物
抗菌药中毒性肾病	疾病
白色链霉菌6016	细菌
茨城病	疾病
腹腔动脉急性闭塞	疾病
肛乳头肥大	疾病
三子止咳胶囊	药物
本雅病毒科	病毒
心因性反应症	疾病
妇科瘤病	疾病
脑灰质异位	疾病
羟芐唑	药物
周期性软瘫	疾病
猪骨软症	疾病
乳癖散结片	药物
真菌性鼻窦炎	疾病
器质性心脏病	疾病
番茄褐色根腐病	疾病
氨茶碱	药物
胃刻宁胶囊	药物
放线菌门	细菌
解磷	药物
猪弓形虫病	疾病
嘴唇黑	症状
风湿灵片	药物
高原心脏病	疾病
止痉散	药物
颠茄浸膏	药物
化妆上瘾	疾病
一滴甲	药物
家兔出血性败血症	疾病
喉咳	疾病
耆鹿逐痹胶囊	药物
性腺发育不全症	疾病
双虎肿痛宁	药物
乳腺疾病	疾病
汉坦病毒肺综合症	疾病
仙鹤胶囊	药物
夜宁糖浆	症状
增光胶囊	药物
汗孔角化症	疾病
塞佛病	疾病
血丝虫病	疾病
鸡线虫病	疾病
盆底失弛缓	疾病
保肾康片	疾病
乳泰胶囊	药物
去爪法	疾病
琥磺胺噻唑	药物
不忘散	药物
后倾	疾病
敷脐法	药物
安他宁	药物
米诺地尔喷雾剂	药物
翼状胬肉	疾病
猪胆道蛔虫性黄疸	疾病
烧伤药膏	药物
右腹部疼痛	疾病
附桂骨痛片	药物
白灵片	药物
舒胆胶囊	药物
养阴镇静片	药物
珍香胶囊	药物
阴道瘙痒	症状
八维钙锌片	药物
职场死机症	症状
惊恐症	症状
枸橼酸铁铵维B1糖浆	药物
无症状性血尿	症状
止咳润肺食疗法	疾病
山楂降压胶囊	药物
儿童解热镇痛安全用药	药物
胃阴不足型慢性胃炎	疾病
兔脑炎原虫病	疾病
马媾疫	疾病
第三代灵芝孢子粉	药物
Clopidogre	药物
三硝基甲苯白内障	疾病
参茸延龄片	药物
克帕醒脑康	药物
月经提前	症状
肝脾消胶囊	药物
副球孢子菌病	疾病
乳酸菌素咀嚼片	药物
黑豆煎	症状
补血丸	药物
荣初症	症状
橄榄黑链霉菌	细菌
慢性龈缘炎	疾病
大疱性皮肤病	疾病
暗红灰链霉菌	细菌
同化激素	药物
联合性免疫缺陷病	疾病
加减柴胡疏肝散	药物
益肤清乳膏	药物
协日嘎四味汤胶囊	药物
强筋松	药物
埃及血孢子虫病	疾病
陶工尘肺	疾病
济生橘核丸	药物
明目羊肝丸	症状
尿感宁冲剂	药物
隐性工伤	疾病
江苏省扬州和平医院	疾病
维铁控释片	药物
肾用氨基酸注射液	药物
足细胞病	疾病
组织胞浆菌病	疾病
阿司匹林散	药物
猪传染性胸膜肺炎	疾病
颅底凹入症	症状
马传染性脑脊髓炎	疾病
复方苯酚糊剂	药物
黑油膏	药物
肺泡微石症	症状
高离氨基酸血症	疾病
尼伐地平	疾病
复方牛黄消炎胶囊	药物
格兰西龙	药物
放射性颌骨骨髓炎	疾病
新生儿败血症	疾病
复方环磷酰胺	药物
流行性腹泻	疾病
鹿茸胶囊	药物
甲状腺异常	疾病
网团菌门	细菌
耳硬化症	疾病
大疱型水痘	疾病
慢性铅中毒	疾病
乳房单纯囊肿	疾病
强力霉素	药物
先天性肌肉萎缩	疾病
筑巢链霉菌	细菌
犬旋毛虫病	疾病
利克妇洁舒洗液	药物
肾皮质髓质脓肿	疾病
T波倒置	疾病
哈喹诺	药物
鸡传染性贫血	疾病
输卵管不通	疾病
牛网尾线虫病	疾病
骨雅司病	疾病
甲磺酸倍他司汀	药物
学校恐怖症	疾病
光毒性皮炎	疾病
水貂病毒性肠炎	疾病
消瘀康片	药物
甲亢灵片	药物
美他霉素	药物
李痘病毒	病毒
儿科七厘散	药物
喘速宁	药物
美容强迫综合征	疾病
血宁胶囊	药物
铜缺乏性贫血	疾病
左炔诺孕酮分散片	药物
利什曼原虫病	疾病
氨酚伪麻分散片	药物
疖疮	疾病
王九正祖传黑膏药	药物
桌面粽子	病毒
真命天女症	疾病
下肢静脉瓣膜关闭不全	疾病
癌痛药	药物
包皮水肿	疾病
牛水中毒	疾病
尼普拉嗪	药物
染色体病	疾病
面部色斑	疾病
猪圆环病毒病	病毒
过敏性鼻炎咳嗽	症状
变态反应性皮肤病	疾病
枸橼酸铁铵维B1糖浆	药物
漏斗胸	疾病
消核片	药物
阿米洛利片	药物
拨云膏	药物
痛风定片	药物
好如临	药物
传染病	疾病
更年期角皮症	疾病
烯丙洛尔	药物
牛巴贝斯焦虫病	疾病
牛羊感冒	疾病
微白黄链霉菌	细菌
眼型重症肌无力	疾病
妇炎平阴道泡腾片	药物
猪依原体病	疾病
魔粉	药物
乌龙散	药物
猪直肠脱出	疾病
复方马其通胶囊	症状
咽喉痒	症状
肛门直肠疾病	疾病
猪肠病毒感染	疾病
维生素K4片	药物
固中丸	药物
假密环菌甲素片	药物
肾性氨基酸尿	疾病
进行性指掌角皮症	疾病
轻度乳腺增生	疾病
维生素K3	疾病
老年人甲亢	疾病
蛋鸡衣原体病	疾病
速克痛600	药物
水脑症	疾病
脑清片	药物
羟基镍中毒	疾病
甲泛葡胺	药物
六味丁香片	药物
互联网手机焦虑症	症状
气象过敏症	症状
猪破伤风病	疾病
洁白片	药物
放射科肠炎	疾病
乌及散	症状
全能流感疫苗	病毒
仔猪硒缺乏症	疾病
化瘀镇痛胶囊	药物
丙酸倍他米松	疾病
郭郎中冷敷贴	疾病
鸡传染性支气管炎	疾病
平衡液	药物
慢粒	疾病
心肌炎	疾病
麝香关节止痛膏	药物
妊娠毒血症	疾病
鸢都感冒冲剂	药物
耐多药肺结核	疾病
中诺威林	药物
厌食病	症状
肝囊肿	疾病
喹乙醇中毒	药物
杨树花叶病毒	病毒
湿痛喜康	药物
台湾一号	病毒
野猪黄痢病	疾病
绞股蓝总甙胶囊	药物
疣微菌门	细菌
病毒性脑膜脑炎	病毒
黑孢链霉菌	细菌
呋布西林钠	药物
鸟蛇线虫病	疾病
周末运动病	症状
羊肝丸	药物
非何杰金氏淋巴瘤	疾病
心脏病	疾病
金银花糖含片	药物
鹿丹芪胶囊	药物
蛭芎胶囊	药物
SH腺体纳米介入疗法	药物
盐酸溴不已胺醇	药物
肺气肿片	药物
节段性白癜风	疾病
比醇氨酯	疾病
病毒性疱疹	疾病
千里马穿墙下载者变种	病毒
香连化滞片	药物
射精出血	症状
兰伯特-伊顿综合征	疾病
猪空肠弯曲菌病	疾病
口腔感冒	疾病
预激症候群	症状
川芎调经茶	药物
继发孔型房间隔缺损	疾病
加味天麻胶囊	药物
胃息肉	症状
牛病毒性腹泻-黏膜病	疾病
黄连姜草止呕茶	药物
猪维生素B缺乏症	疾病
妊娠合并硬皮病	疾病
主诉	症状
牛传染性角膜炎	疾病
职业性腰背痛	疾病
早期骨癌	疾病
通草酿酒	疾病
人畜共患病	疾病
歪嘴哭综合症	疾病
关节炎胶囊	药物
合成药物	药物
菜豆单囊壳	疾病
鸡淋巴白血病	疾病
虹彩病毒科	病毒
Kaposi肉瘤	疾病
猫流感	疾病
老年再生障碍性贫血	疾病
猪传染性胃肠炎	疾病
偶合症	疾病
猪卵巢机能减退	疾病
慢脓耳	疾病
次硝酸铋片	药物
猪细小病毒病	疾病
腺型继发败血型鼠疫	疾病
脑弓形体病	疾病
精胺丁二酸酵素缺乏症	疾病
欢乐时光病毒	病毒
盐酸美散痛	药物
毒蛇咬伤	疾病
纤维素诺卡氏菌	细菌
疗肺宁片	药物
芪余口服液	症状
川贝梨糖浆	药物
歌舞伎症候群	疾病
细菌性尿道炎	疾病
禽结核病	疾病
复方南板蓝根冲剂	药物
川贝雪梨胶囊	药物
降胆葡胺DEAE	药物
内科医生	疾病
遗传缺陷	疾病
早发性痴呆	疾病
依帕司他	症状
汉防己散	药物
犬蠕形螨病	疾病
幼年类风湿性关节炎	疾病
吐泻肚痛胶囊	药物
米可定阴道泡腾片	症状
妇炎康凝胶	药物
鸭传染性浆膜炎	疾病
酰胺比咯烷酮	药物
阿司唑	药物
秋燥	疾病
强肝片	药物
spoclsv	病毒
吲哚心安	药物
特丽仙胶囊	药物
活力链霉菌	细菌
养心定悸胶囊	药物
八仙油	药物
感冒清热冲剂	药物
协生作用	症状
猪诺卡氏菌病	疾病
脑血管破裂	疾病
薄膜包衣	药物
复合型心力衰竭	疾病
杜鹃素	药物
急性细菌性结膜炎	疾病
回生甘露丸	药物
三十五味沉香丸	药物
《四诊抉微》	疾病
福辛普利钠	药物
严重心律失常	疾病
加味霍香正气丸	药物
施马伦贝格病毒	病毒
神经皮肤黑变病	疾病
前胃弛缓	疾病
脂质贮积病	疾病
鸡传染性肌胃炎	疾病
氨麻美敏胶囊	药物
鸡卡氏白细胞原虫病	疾病
茜芷片	药物
假道现象	症状
肺包虫囊肿	疾病
老年脑萎缩	疾病
儿童鼻窦炎	疾病
重感灵胶囊	药物
志贺杆菌病	疾病
拘楼病	疾病
鸭伪结核病	疾病
陆英胶囊	药物
牛轮状病毒病	疾病
手机依赖症	疾病
沙美特罗气雾剂	药物
结晶样视网膜变性	疾病
兔泰泽氏病	疾病
黄疸茵陈冲剂	药物
成脓期	疾病
甲状腺功能失调	疾病
肝肉芽肿病	疾病
浅龋	症状
桂蒲肾清片	药物
感冒欣喷雾剂	药物
热带病	疾病
椒油炝芹菜	疾病
先天性弓形体病	疾病
肉鸭嗜水气单胞菌病	疾病
红叶型天疱疮	疾病
糖维胶囊	药物
肺结核病	疾病
猪食道口线虫病	疾病
头风镇痛丸	药物
鸡包涵体肝炎	疾病
唇疮	病毒
心肌硬化	疾病
参莲颗粒	症状
小儿暑温	疾病
链球菌	细菌
通滞苏润江片	药物
保心宁胶囊	药物
乌附苁蓉丸	药物
酸杆菌门	细菌
吸入麻醉药	药物
猪衣原体病	疾病
衣原体病	疾病
慢性白血病	疾病
卵巢单纯囊肿	疾病
党参郁金蚤休汤	药物
白带黄	症状
风湿	疾病
恶心	症状
知母片	症状
全身乏力	症状
金双歧胶囊	药物
网状青斑症	疾病
复方满山红糖浆	药物
疑似职业病	疾病
假性性早熟	疾病
孕妇肚皮痒	疾病
阴茎结核	疾病
溺爱综合征	疾病
空调肩	症状
浑睛虫病	疾病
噻美尼定	药物
生地黄酒	药物
清喉咽合剂	药物
鸡血藤膏	药物
组织细胞增多症	疾病
慢性副鼻窦炎	疾病
犬出血性胃肠炎	疾病
NotPetya	病毒
风赤疮痰	疾病
咬指甲	疾病
轻度弱智	症状
披发糖多孢菌	细菌
急性巨核细胞白血病	疾病
复方百部止咳糖浆	药物
雪松病毒	病毒
苦参膜	药物
羟哌氟丙硫蒽癸酸酯	疾病
感冒咳嗽	症状
苗山鞘膜方	药物
常年过敏性鼻炎	疾病
猪钙磷缺乏症	疾病
双解散	药物
驱毒养颜口服液	药物
双达芬	症状
马蹄足内翻	疾病
复方甘草甜素注射液	药物
蓝舌病	疾病
痢泻灵片	药物
勒马回胶囊	药物
热微菌门	细菌
功能性疾病	症状
擦洗法	疾病
鸽痘	疾病
乳酸钠林格	药物
阿米巴菌	疾病
角膜糜烂	症状
氟罗沙星	药物
老年性青光眼	疾病
副伤寒甲	疾病
复方止咳片	药物
西尼罗热	疾病
X染色体脆折症	疾病
卑谍	疾病
消瘿五海丸	药物
葛根胶囊	药物
宫颈炎康栓	药物
健脑益智胶囊	药物
鸡痛风症	疾病
日晒痴迷症	疾病
种痘样水疱病	疾病
甘露六烟酯片	药物
镜子恐惧症	疾病
冠病毒	病毒
乐感清	病毒
胆木浸膏片	药物
贞婷乳康贴	疾病
建曲	药物
热伤神明	症状
解表追风丸	药物
抗胰蛋白酶缺乏症	疾病
慢性腹泻	症状
老化	疾病
牛奶咖啡斑	疾病
小儿韦格纳肉芽肿	疾病
星瑙灵片	药物
醉八虫	疾病
环状肉芽肿	疾病
药用玫瑰	症状
盐酸吡咯吡胺	疾病
鸡克雷伯杆菌病	疾病
斯特格病	疾病
猪支原体性肺炎	疾病
鸭疫里默氏杆菌病	疾病
杞蓉胶囊	药物
解郁安神胶囊	药物
肛瘘便血	疾病
丹王颗粒	药物
孝感奥视眼科医院	疾病
羟乙基磺酸戊双米	药物
僵猪症	疾病
色吸水链霉菌	细菌
尿毒清颗粒	药物
二黄炖母鸡	疾病
猫泡翼线虫病	疾病
接骨木根	症状
胃得宁胶囊	药物
干燥性角膜结膜炎	疾病
叶金排石胶囊	药物
《中医诊断学》	疾病
鸟贾第鞭毛虫病	疾病
粒线体缺陷	疾病
小鹅瘟	疾病
氧化溴铵	疾病
花椰菜花叶病毒	病毒
猪桑葚心病	疾病
牛血孢子虫病	疾病
曲霉性鼻窦炎	疾病
禽住肉孢子虫病	疾病
帝中喉风	症状
犬感冒	症状
遗传性黄斑变性	疾病
儿科医生红黑榜	疾病
舌出不收	疾病
维肤克星乳膏	药物
视野缩小	疾病
人造病	疾病
青春期心性焦虑	症状
痔疮宁栓	药物
颠茄流浸膏	药物
寨卡热	疾病
病理诊断	疾病
噪声病	疾病
腺病毒55型	病毒
复方石淋通胶囊	药物
复方奎宁	药物
可福乐	疾病
鸡淋巴性白血病	疾病
周末焦虑症	疾病
清虱灵	药物
那可汀	药物
猪败血性链球菌病	疾病
益气和胃胶囊	药物
小儿导赤片	药物
甲磺酸二氢麦角碱	症状
鼠疫	疾病
淀粉酶产色链霉菌	细菌
益康宁片	药物
胆酸止咳片	症状
金刚胶囊	药物
心脏右移	疾病
刮痧疗法	疾病
心乐片	症状
动脉血栓性脑梗死	症状
一厘金	药物
胃动素	症状
通便消痤片	药物
多培沙明	药物
龙圣堂消癌平片	药物
银花感冒冲剂	药物
十大功劳根	症状
出疹	症状
液氮冷冻治疗	病毒
固心丹	药物
胆道蛔虫病与肝蛔虫病	疾病
保肠散	药物
速效鼻敏感丸	药物
牙周病综合症	疾病
急性鼻炎	疾病
焊菜素片	药物
肛管脓肿	疾病
细螺旋体病	疾病
复方降压平片	药物
十味乳香散	药物
遗传性骨骼发育不良	疾病
艾叶酒	药物
猪坏死杆菌病	疾病
牛羊骨软病	疾病
幼儿过敏性鼻炎	症状
复肾宁胶囊	药物
喘乐氮嘌酮	药物
龙泰通脉口服液	药物
氟他米特	药物
外阴天疱疮	疾病
衣原体门	细菌
五氯酚中毒	疾病
宿州和美医院	疾病
妇科癌病	疾病
黄柏车前苡仁汤	疾病
珍珠母丸	药物
叶酸缺乏症	疾病
宫腔粘连综合征	症状
阿胶黄芪口服液	药物
化瘀祛斑胶囊	药物
肛门潮湿	症状
鸡白血病	疾病
云母尘肺	疾病
乳酸左氧氟沙星	药物
腮腺炎	疾病
骨质软化症	疾病
猪蠕形螨病	疾病
暑疖病	疾病
参芪五味子胶囊	药物
鸡肌胃糜烂症	疾病
猪砷中毒	疾病
猪坏死性皮炎	疾病
外阴黑色棘皮症	疾病
猪软骨病	疾病
披发糖多孢菌神户亚种	细菌
夏季热病	疾病
牛副丝虫病	疾病
口干	症状
舒尔经片	药物
经断前后诸证	症状
眼睛充血	症状
牛皮癣	疾病
芙蓉膏	药物
结核潮热茶	疾病
痤疮	疾病
猪水疱性疹	疾病
福锑	药物
康妇软膏	药物
偏二甲基肼中毒	疾病
内源性	疾病
意鲁顿	药物
灵芝孢子粉软胶囊	药物
亨德拉病毒	病毒
免疫性肾炎	疾病
直肠脱出	疾病
希莶风湿片	药物
白蛉热	疾病
黄平面鱼	药物
扁瘊病	疾病
黑点癣	疾病
黑素障碍性皮肤病	疾病
冷凝集素综合征	疾病
猪子宫炎	疾病
压力病	疾病
蒂莫西·雷·布朗	疾病
红皮型牛皮癣	药物
基孔症	疾病
高尿酸	疾病
猪虱病	疾病
新生儿湿疹	疾病
偏头痛等位发作	症状
格陵兰史前细菌	细菌
非氨酯	药物
大黄三七散	药物
戊胺庚烷	药物
苯环利定	药物
气滞胃痛胶囊	药物
犬髋关节发育不良	疾病
气压伤性鼻窦炎	疾病
柏栀祛湿喷雾剂	药物
泌尿生殖系阿米巴病	疾病
康艾扶正片	药物
妊娠下肢抽筋	疾病
罗红霉素颗粒剂	疾病
安络痛胶囊	药物
动脉硬化	疾病
不寐病	疾病
左心室发育不良	疾病
反病毒杀手变种BE	病毒
痔炎消胶囊	药物
泼尼松片	药物
二十五味肺病丸	药物
氯丙嗪药物中毒	疾病
其他沙门菌感染	疾病
扁虫病	疾病
高脯胺酸血症	疾病
颈椎反弓	疾病
书写痉挛症	疾病
补益强心片	药物
奥昔非君片	药物
喘舒片	药物
肝复乐胶囊	药物
六锐胶囊	药物
去乙酰毛花甙丙	药物
乳疾灵胶囊	药物
清肝降酶茶	药物
儿童直肠息肉	疾病
内丹	药物
糖酸二氯尼特	疾病
癌痛宁	药物
新免疫靶向疗法	病毒
儿童热性癫痫	疾病
脉管炎片	药物
山甘草根	症状
剧药	药物
山羊布鲁氏菌病	疾病
醋柳酸	症状
乳头溢液	症状
病原携带者	症状
副霍乱	疾病
猪虱虫病	疾病
猪蛔虫病	疾病
猪霉形体肺炎	疾病
环磷酰胺	药物
月经不调症	疾病
依他康唑	药物
阴癣	疾病
IgA天疱疮	疾病
丙缓脉灵	疾病
纵隔血肿	疾病
鲁南欣康	药物
食道型颈椎病	症状
吐酸	症状
双腔吸虫病	疾病
黄疸肝炎茶	药物
囊肿	疾病
离子通道病	疾病
芝麻茎点枯病	疾病
汗疱疹	疾病
微血管减压术	症状
姜糖葱白饮	药物
桑椹密膏	药物
通草茶	疾病
三联疗法	细菌
伊朗白斑膏	药物
丙酸交沙霉素	药物
脉冲磁电固本止颤疗法	疾病
舒康宁凝胶	药物
斯卫尔	药物
职业性喉病	疾病
乳宁胶囊	药物
鸡鼻气管鸟疫杆菌感染	疾病
丙卡巴肼肠溶片	药物
便秘性结肠炎	疾病
非伤寒沙门菌感染	疾病
钙铁锌硒片	药物
小儿咳喘	疾病
烟酰胺葡萄糖注射液	药物
避孕后闭经综合征	症状
光敏性皮炎	疾病
赛美欣	疾病
周期性头痛	疾病
交感神经切断术	疾病
四秋症	症状
四季青消炎喉片	药物
马胃虫病	疾病
全科医生制度	疾病
原发性免疫缺陷病	疾病
白血病髓外复发	症状
真菌竹黄胶囊	药物
石辛含片	药物
恋爱胆怯症	疾病
网膜囊肿	疾病
家禽痛风	疾病
非淋菌性阴道炎	疾病
苯扎托品	药物
野苏胶囊	药物
颈椎病刮痧法	疾病
中长链脂肪乳注射液C	药物
淀粉样变病	疾病
注射用重组链激酶	疾病
西方马脑炎	疾病
心脏损伤后综合征	疾病
禽毛滴虫病	疾病
肝复1号	药物
化学治疗剂	疾病
沙蚤病	疾病
山羊脑脊髓丝状线虫病	疾病
寒者热之	疾病
瘕聚	疾病
铁粒幼细胞性贫血	疾病
寒则收引	症状
时尚心理病	疾病
肛肠病	疾病
阿归养血胶囊	药物
产褥中暑	疾病
嗜酸性细胞性肺炎	疾病
骨痛丸	药物
参三七伤药胶囊	药物
和畅美洛昔康片	疾病
喉部麻风	疾病
少林正骨精	药物
血管性脊髓病	疾病
小蠕虫变种AR	病毒
东科瑞宝降压仪	症状
激素依赖性痤疮	症状
慢性特发性低钾血症	疾病
食道梗阻	疾病
感冒片	药物
五联一体滋髓疗法	疾病
通脉降脂片	药物
格列喹酮分散片	药物
蜗牛炸弹	病毒
英托利匹特	药物
副流行性感冒病毒感染	疾病
牛双芽巴贝斯焦虫病	疾病
蛇缠身	疾病
播散性暗色丝孢霉病	疾病
病毒入侵	病毒
躁狂综合征	疾病
猪巨细胞病毒感染	疾病
丹桅逍遥丸	药物
地洛特	药物
金酸萍片	药物
丹参丸	药物
咯血病	疾病
Orkambi	药物
圆柏叶	症状
半慢胰岛素锌混悬液	疾病
血色病性骨关节病	疾病
风湿热	疾病
宫环出血	疾病
铁锌钙咀嚼片	药物
巨腿症	疾病
前列舒泰	药物
夏枯草降脂茶	症状
金羚感冒胶囊	药物
手臂振动病	疾病
蛲虫病	疾病
变异链球菌	细菌
青春宝永真片	药物
铬酸盐制造业工人肺癌	疾病
ceritinib	药物
囊尾蚴病	疾病
狗湿疹	疾病
复方乳酸溶液	药物
妇宁康胶囊	药物
兔梭菌性下痢	疾病
生蛇	疾病
下载者迎风号	病毒
风热感冒药物	药物
透骨膏	药物
婴儿坏疽性皮炎	疾病
盾克金蚧片	药物
大顺散	药物
产褥期抑郁症	症状
小狗上学病毒	病毒
复发性髌骨脱位	疾病
五甲烯四氮唑	疾病
皮肤细菌感染	疾病
福可定片	药物
痹痛酊	药物
心宁	药物
宅男病毒	病毒
ANI病毒	病毒
二溴卫矛醇	药物
麦利占替诺	疾病
湿毒瘙痒软膏	药物
止血散	药物
戊四硝酯	药物
真空病	疾病
马来酸曲美布丁片	药物
乌金胶囊	药物
堵车烦躁症	疾病
两性霉素B阴道泡腾片	药物
牛羊李氏杆菌病	疾病
猪圆环病毒感染	疾病
麻将肩	症状
褐色水样白带	症状
卵圆孔未闭	疾病
健忘	症状
复方石斛片	药物
新生儿坏死小肠结肠炎	疾病
维生素咀嚼片	药物
幼鸭白肌病	疾病
益母草注射液	药物
黑虎散	药物
被迫妄想症	疾病
氯丁二烯中毒	疾病
海马巴戟胶囊	药物
血证口渴茶	药物
六耳猴症	疾病
牛肺结核病	疾病
橘红枇杷胶囊	药物
良性新生儿家族性惊厥	疾病
散痛舒分散片	药物
木薯普通花叶病毒	病毒
三硝基甲苯中毒	疾病
卵巢保养	疾病
锁阳补肾胶囊	药物
尔可平糖浆	药物
药物生物合成	药物
孕妇金花片	药物
慢性结直肠炎	疾病
氮卓斯丁	药物
感染性疾病	疾病
三阳经疟	疾病
安中片	药物
小青龙汤加味	药物
百里香精油	病毒
急重症护理学	疾病
职业性中毒性肝病	疾病
小儿回春丸	药物
婴儿安片	药物
呼吸系统疾病	疾病
白苓胶囊	药物
猪马铃薯中毒	疾病
利尿剂	药物
交肠病	疾病
回春胶囊	药物
山栀石膏散	药物
TORCH综合症	症状
急性食管炎	疾病
马传染性子宫炎	疾病
凉燥病	疾病
妇炎灵胶囊	药物
氟地西泮	药物
被害妄想症	症状
犬布氏杆菌病	疾病
胃尔康片	药物
赖诺普利	药物
亚历山大症	疾病
复方四环素泼尼松膜	疾病
青少年型青光眼	症状
慢性子宫颈炎	疾病
寒性哮喘	疾病
尿酸性肾病	疾病
急性骨髓性白血病	疾病
微小膜壳绦虫病	疾病
幽闭空间恐惧症	症状
猪传染性萎缩性鼻炎	疾病
安胃止痛胶囊	药物
番茄斑萎病毒	疾病
肛门疼痛	症状
痿症	疾病
传染性支气管炎	疾病
永达堂珍珠燕窝七厘散	药物
双歧胶囊	药物
播散性毛霉病	疾病
鸡波氏杆菌病	疾病
核黄疸	疾病
小柴胡胶囊	药物
遗传病	疾病
肺部疾病	疾病
无症状乙肝大三阳	症状
棉花黄萎病菌	疾病
眼睛淤血	症状
牛边虫病	疾病
玉锁匙	药物
血吸虫性肝病	疾病
补胃丸	药物
健脑安神片	药物
腹鸣	症状
仙乐雄胶囊	药物
知柏茶	药物
慢性脑积水	疾病
灯盏花素分散片	药物
视网膜疾病	疾病
鼻阻塞	症状
过敏性皮肤病	疾病
反病毒杀手变种CC	病毒
天麻甙	药物
安神镇静二十味丸	药物
乳头多瘤空泡病毒	病毒
砷化氢中毒	疾病
冲洗室	疾病
乳糖酶片	药物
夜宁口服液	药物
氨咖甘	药物
拇囊炎	疾病
微球剂	药物
川贝虫草炖水鸭	疾病
蝙蝠狂犬病病毒	病毒
卡塔格内综合征	疾病
急性脑血管病	疾病
藏书癖	症状
丙酸己烷雌酚	药物
老年痛风	疾病
有毒链霉菌	细菌
五淋化石胶囊	药物
瑞特氏症候群	疾病
细胞周期特异性药物	药物
消积化虫散	药物
肋软骨非感染性炎症	疾病
堵车急躁症	疾病
犊牛脐炎	疾病
犬疥癣病	疾病
获得性面部皮肤衰老症	疾病
远志汤	疾病
仲景牌桂附地黄丸	疾病
赛胃安胶囊	药物
复方氨基丁酸维E胶囊	药物
疑似病例	疾病
颈肩腕综合征	疾病
外阴血吸虫病	疾病
培元骨愈膏	疾病
莱姆症	疾病
复方芜花根皮酒	药物
禽球虫病	疾病
修正颈腰康胶囊	药物
虎黄汤	药物
感染性皮肤病	疾病
复方蛇胆川贝散	药物
慢性结肠炎方	药物
硫异烟胺	药物
痔炎消片	药物
皮肤龟裂	症状
猪玉米赤霉烯酮中毒	疾病
瞳子高	症状
膝关节急性滑膜炎	疾病
外阴假上皮瘤样增生	疾病
强力止咳宁胶囊	药物
丝状疣	疾病
膝关节内紊乱	疾病
超级抗药细菌	细菌
天仙解毒胶囊	药物
松生等	疾病
泛发型白癜风	疾病
人芽囊原虫病	疾病
血孢子虫病	疾病
百忧解20	药物
强迫行为	疾病
黄水疮药	药物
慢性皮肤溃疡	疾病
拜心通	药物
活络酊	药物
龙骨颈椎胶囊	药物
冷纤维蛋白原血症	疾病
羰基镍中毒	疾病
膏肓病	疾病
急性脊髓前角灰质炎	疾病
多发性骨髓瘤肾病	疾病
已酸羟孕酮注射液	药物
社交强迫症	症状
节日恐惧症	疾病
异常放电综合征	疾病
乌蛇止痒膏	药物
胃复胶囊	药物
风湿尔康气雾剂	药物
甲麦角林	药物
肺毛细线虫病	疾病
妇科再造胶囊	药物
良性新生儿惊厥	疾病
鸡霉菌性肺炎	疾病
通益乐平	药物
躯体化障碍	疾病
接骨续筋胶囊	药物
慢性胆囊炎和胆石症	疾病
补血安神胶囊	药物
剩女焦虑症	疾病
复方青黛片	药物
拜阿司匹灵咀嚼片	药物
橙子核	疾病
产色链霉菌	细菌
猪铜缺乏症	症状
再植病	症状
猪大肠杆菌病	疾病
醇中毒	症状
心火内炽	症状
男性小腹坠痛	症状
韭枣白芥	药物
格列美脲分散片	药物
高原缺氧性心肌病	疾病
八味小檗皮胶囊	药物
非洲马瘟	疾病
止嗽扫痰丸	药物
膜迷路积水	疾病
威尔佐夫变种VU	病毒
蚕退纸	症状
坎利酸钾	药物
复发型斑疹伤寒	疾病
鼻病	疾病
通用流感疫苗	病毒
毛尾线虫病	疾病
慢性再生障碍性贫血	疾病
奥马珠单抗	药物
刚毛链霉菌	细菌
鼻病毒感染	疾病
拉呋替丁片	药物
龙胆泻肝软胶囊	药物
金钱木根	症状
地黄石斛丸	药物
特发性尿钙增多症	疾病
原发性红斑性肢痛症	疾病
无花果叶扁豆	疾病
胆清片	药物
蠕虫蚴移行症	疾病
复方菌维克	药物
职业病	疾病
全身性粟粒性皮肤结核	疾病
单基因遗传病	疾病
溃疡病	疾病
五参芪口服液	药物
钡及其化合物中毒	疾病
耐内酰胺链霉菌	细菌
风痰中络	疾病
多基因遗传病	疾病
玉蓝降糖胶囊	药物
异环磷酰胺	药物
日本双喜牌金粒救心丹	疾病
健脑益智丸	药物
益母草流浸膏	药物
SNR导航超微疗法	疾病
H6N1	病毒
排毒养颜片	药物
老年颈性眩晕	疾病
疗霉舒霜剂	药物
钻地老鼠	疾病
超邦黄精胶囊	药物
壶菌病	疾病
犬细小病毒病	疾病
后侧索联合变性	疾病
泪器疾病	疾病
侏儒综合征	疾病
以情胜情疗法	疾病
猪鞭虫病	疾病
毒隐翅虫皮炎	疾病
隐裂	疾病
肺弓形体病	疾病
穿心莲内酯片	药物
冲动性自杀	疾病
水俣病	疾病
满月面容	症状
Petya	病毒
家族性失眠症	疾病
硝敌链霉菌	细菌
石家庄蓝天皮肤专科	疾病
三七止血胶囊	药物
生物技术药物	药物
涕必灵	药物
暑劳	疾病
戊四唑	药物
脑梗塞后遗症	症状
牛羊膀胱炎	疾病
产后康膏	药物
地震瘟疫	疾病
先天性乳清酸尿症	疾病
猪蠕形螨虫病	疾病
咽灼伤	症状
百癣夏塔热分散片	药物
膈	疾病
陇马陆胃药	药物
浮霉菌门	细菌
性梦游	疾病
华以苦瓜洋参软胶囊	药物
色素减退	疾病
阴道滴虫病	疾病
舒宫宝	细菌
威尔森氏病	疾病
犬瘟热病	疾病
安胎白术茶	药物
九里香根	症状
天杞补肾胶囊	药物
草莓细菌性叶斑病	细菌
复方大青叶栓	药物
金思平	症状
猪伪狂犬病	疾病
多头蚴病	疾病
苗草癣中药乳膏	药物
家而康洁阴消毒液	药物
小肠疝	疾病
CREs	细菌
澳泰乐片	药物
手机骷髅病毒	病毒
西米脾	疾病
腰骶部劳损	疾病
妄想性精神分裂症	疾病
复方氯化钠	药物
氨氯地平胶囊	症状
男康片	药物
猫呼吸道综合征	疾病
微小病毒科	病毒
吴太感康	症状
氢氟噻嗪	药物
高胱氨酸尿症	疾病
正粘病毒	病毒
盐酸氯苯丁嗪	药物
降脂宁片	药物
先天性动脉瘤	疾病
人参竹茹汤	药物
遗传性血小板减少症	疾病
原发性高脂蛋白血症	疾病
牛羊伪狂犬病	疾病
脱铁杆菌门	细菌
江西肝病网	疾病
紫色链霉菌	细菌
头部牛皮癣	疾病
急性丁型肝炎	疾病
坏死杆菌病	疾病
过敏性哮喘	疾病
暑温	疾病
白眼病	疾病
胃得乐	药物
猪蓝眼病	疾病
猝睡症	疾病
通便宁片	药物
眼出血	疾病
转行焦虑症	症状
梨白粉病	疾病
肺良性肿瘤	症状
单纯扁平骨盆	症状
爱罗苏	药物
降糖片	疾病
鼻气管鸟疫杆菌感染	疾病
外阴阿米巴病	疾病
猪痘病毒	疾病
鹤蟾片	药物
维生素C颗粒	药物
沉香十七味丸	症状
ThermoDox	药物
宫颈难产	疾病
穿黄清热胶囊	药物
人参糖肽	药物
倍氟米松	药物
烬灰天色链霉菌	细菌
归芪活血胶囊	药物
基孔肯尼亚热	疾病
犬心肌炎	疾病
性疾病	疾病
湿热证	症状
大重量牵引法	疾病
烟雾病	疾病
慢型克山病	疾病
缓释胶囊	药物
犬钩端螺旋体病	疾病
桃根	症状
山度霉素	疾病
猪结核病	疾病
棘口吸虫病	疾病
水痘和带状疱疹	病毒
大黄通便胶囊	药物
肺火病	疾病
间歇性歇斯底里	疾病
尼帕病毒	病毒
反义寡核苷酸	药物
仔猪低血糖病	疾病
病毒性宫颈炎	疾病
懒病	疾病
可他敏	药物
三氯乙烯中毒	疾病
三唑仑	药物
兔瘟	疾病
球虫病	疾病
风轮止血片	疾病
假性发作	疾病
依托泊苷	药物
皮肤白斑病	疾病
云南白药片	药物
超高热危象	症状
商陆酒	药物
玉芝丸	药物
伏气温病	疾病
乳脂链霉菌	细菌
润通	药物
止嗽咳喘宁糖浆	药物
强生源胶囊	药物
猪蓖麻中毒症	症状
舍吲哚	药物
肾炎肾病综合症	疾病
乌药顺气散	药物
壮骨止痛胶囊	药物
一般反应	症状
君寿消癌平片	药物
禽白血病	疾病
全髓白血病	疾病
火鸡球虫病	疾病
精神感冒	疾病
精神官能症	疾病
白呋唑	疾病
脑力隆	症状
猫传染性腹膜炎	疾病
养真丸	药物
气眠症	疾病
溶霉菌链霉菌	细菌
瘟疫	疾病
茵栀黄软胶囊	药物
黄精四草汤	疾病
益肤霜	药物
迪沙头孢拉定颗粒	药物
剌激性泻药	药物
宫颈囊肿疾病	症状
点头症	疾病
地榆油膏	药物
永达堂舒筋止痛膏	药物
硝酸硫康唑喷雾剂	药物
口腔内科学	疾病
疫疠	疾病
参苏感冒片	药物
论坛综合症	疾病
猪便秘	疾病
特发性婴儿动脉硬化	疾病
Nucleozin	病毒
羽毛恐惧症	症状
类风湿性心脏病	疾病
酒石酸苯茚胺	药物
卵泡萎缩	疾病
爱眼日	疾病
绒毛活检	疾病
呕血与黑粪	症状
禽弯曲杆菌性肝炎	疾病
昂丹司琼片	药物
尘螨过敏性鼻炎	疾病
视网膜中央静脉血栓	疾病
高考后综合征	症状
仔猪葡萄球菌性皮炎	疾病
盐酸芐丙酚胺	药物
阿莫西林克拉维酸片	药物
抗黑瘤素	药物
伤痛宁胶囊	药物
中分化鳞癌	疾病
猪布鲁氏菌病	疾病
家庭聚集性乙肝	病毒
心脑欣片	药物
暴仆	症状
说谎癖	疾病
外阴皮肤脂溢性皮炎	疾病
火车心理焦虑症	疾病
阴囊尖锐湿疣	疾病
复方百部止咳冲剂	药物
产后乳腺炎	疾病
姜叶	疾病
成髓细胞白血病	疾病
辅酶Q10维E软胶囊	药物
急性淋巴细胞性白血病	疾病
地锦草胶囊	药物
粘液瘤病毒	疾病
断血流分散片	药物
小孩过敏性紫癜	疾病
保胎灵胶囊	药物
红歌疗法	疾病
纤维素样变性	疾病
大七香丸	药物
珊瑚诺卡氏菌	细菌
眼药水	疾病
禽癣病	疾病
五酯软胶囊	药物
鼻渊片	药物
尿道分泌物	症状
西米替丁胶囊	药物
消黄散	药物
绝育	疾病
乳康搭档	药物
锑酚	疾病
党参片	药物
利尿降压药	药物
香港骨康灵	药物
OPSI	症状
羊链球菌病	疾病
脑血康丸	药物
蜜蜂微粒子病	疾病
贝诺孢子虫病	疾病
六神胶囊	药物
外科感染	疾病
复方鹧鸪菜散	药物
烟酒中毒性弱视	疾病
氟中毒	疾病
腐蚀疗法	药物
白化病	疾病
猫瘟热	疾病
遗传精神病	疾病
山棯根	症状
急迫性尿失禁	症状
化能合成细菌	细菌
甘参胶囊	药物
破裂性思维	症状
信息综合症	症状
双黄连滴眼剂	药物
深圳武警男科医院	疾病
风湿圣药胶囊	药物
冠心七味片	药物
遗传性凝血因子Ⅴ缺乏	疾病
呼肠孤病毒	病毒
甲肝汤	药物
乳嗽	疾病
环丙沙星	药物
密码强迫症	疾病
桃花酒	疾病
退伍军人症	疾病
胆道华支睾吸虫病	疾病
紫色非硫细菌	细菌
经期综合症	症状
新型高传染性菌株	病毒
参茸天麻酒	疾病
外照射慢性放射病	疾病
心绞痛	症状
百咳灵片	药物
肺结节	疾病
喉关痈	疾病
火鸡蓝冠病	疾病
参附代血浆	疾病
妊娠风疹	病毒
礞石滚痰片	药物
贝羚胶囊	药物
苛养菌	细菌
Unituxin	药物
明麻散	药物
结核性风湿症	疾病
口炎清胶囊	药物
盐酸氨酚奎琳	症状
大黄蟅虫胶囊	药物
大茶药根	症状
双宝素口服液	药物
氨酪酸片	药物
小孩过敏性鼻炎	症状
鸭传染性窦炎	疾病
苯乙肼	药物
抗病毒咀嚼片	药物
戊炔雌三醇	药物
急性肠炎	疾病
仔猪气喘病	疾病
鸡爪疯	疾病
小腹刺痛	症状
胸外科	医学专科
神经外科	疾病
皮肤科	疾病
毛细血管扩张症	疾病
恶心	症状
颅骨骨折	疾病
肛门坠胀	症状
泪溢	症状
肋间神经痛	症状
疱疹	疾病
儿童大便失禁	疾病
念珠菌感染	疾病
耳硬化症	疾病
视野缩小	疾病
强迫行为	疾病
腹鸣	症状
过度通气	症状
手足麻木	疾病
黑蒙	症状
圆形或卵圆形丘疹或结节	症状
黄斑囊样水肿	疾病
腹胀	症状
食欲减退	症状
脑疝	药物
吞咽困难	症状
核黄疸	疾病
外阴烧灼刺激感	症状
消化不良	疾病
高血压	疾病
反复鼻出血	症状
耳后疼痛	疾病
外阴下坠感	症状
皮肤龟裂	症状
倒睫	疾病
骶髂关节疼痛	症状
剥脱性皮炎	疾病
过度换气综合征	疾病
烧心	症状
囊肿	疾病
心脏震颤	疾病
夹层动脉瘤	疾病
咽喉疼痛	症状
胸腰驼背	疾病
胃扩张	疾病
大骨节病	疾病
胆汁性肝硬化	疾病
梦行症	疾病
嗜睡	疾病
空气栓塞	疾病
炎性外痔	疾病
智能减退	症状
角膜糜烂	症状
免疫性肾炎	疾病
虹视	症状
末指短小向内弯曲或只有两指节	症状
疥疮	疾病
心慌气短	症状
肾性糖尿	疾病
足穿孔	疾病
指节垫	症状
妊娠毒血症	疾病
健忘	症状
妊娠期急性脂肪肝	疾病
脑室出血	疾病
心律失常	疾病
光反射消失	疾病
肺性肥大	症状
思维缓慢	症状
进食困难	症状
肾动脉狭窄	疾病
躯体化障碍	疾病
心包内出血	疾病
室间隔缺损	疾病
肛门疼痛	症状
盆腔脓肿	疾病
肺间质纤维化	疾病
呼吸道狭窄	疾病
腹膜炎	疾病
心绞痛	症状
三角头畸形	症状
轻瘫	疾病
脐周疼痛	疾病
眼睑下垂	症状
血脂异常	疾病
食管溃疡	疾病
神经症性抑郁	症状
四肢麻木	症状
血尿	症状
恶心与呕吐	症状
胎儿窘迫	症状
喉部刺痛	症状
上半身热刺激性多汗	疾病
瘙痒	症状
肠胀气	症状
考试综合症	症状
肛乳头肥大	疾病
排尿不畅	症状
跖反射伸性	症状
先兆子痫	症状
