新生儿溶血病	疾病
巴比妥酸盐	药物
地氯雷他定	药物
炭疽	疾病
脑梗塞后遗症	症状
肛门湿疣	疾病
氮芥	药物
棘口吸虫病	疾病
钩蚴性皮炎	疾病
感冒清热冲剂	药物
米开民	药物
胃肠食物不耐受症	症状
泊瑞	药物
噬菌体	细菌
梭杆菌门	细菌
绿弯菌门	细菌
热脱硫杆菌门	细菌
纤维杆菌门	细菌
肉毒杆菌	细菌
2019新型冠状病毒感染肺炎	疾病
先天性梅毒	疾病
隐性梅毒	疾病
淋巴结肿大	症状
神经	症状
梅毒	疾病
奇孔古尼亚病毒性疾病	疾病
厌食	疾病
右心室肥大	症状
前列腺分泌物含有许多脓缩细胞	疾病
淀粉样变心肌病	疾病
腹泻	症状
肉毒中毒	疾病
淋病	疾病
并发症	疾病
类鼻疽	疾病
莱姆病	疾病
肌肉疼痛	症状
吐白沫痰	症状
皮肤溃疡	疾病
头皮平直裂口	症状
咽部灼热疼痛	症状
中毒性肺水肿	疾病
头面焮红肿胀	症状
头虱病	疾病
手背部皮肤发红肿胀	症状
外阴硬化性苔藓	疾病
非细菌性前列腺炎	疾病
眼睑呈紫红色	症状
肛廔	疾病
口咽部水疱状损害	症状
婴儿湿疹结痂	症状
肠道革兰阴性杆菌脑膜炎	细菌
Shy-Drager综合征	疾病
四肢麻木	症状
胆胀	疾病
肺宫崎肺吸虫症	疾病
尿失禁与遗尿	症状
局灶性节段性肾小球硬化	疾病
发热伴有皮疹	症状
图形定向障碍	症状
小胃综合征	症状
冷凝集素综合征	疾病
遗传病	疾病
下半身消瘦型	症状
胃畸胎瘤	疾病
原发性急性肾小球肾炎	疾病
Q角异常	疾病
泌尿生殖系阿米巴病	疾病
掌跖角化过度	症状
剧烈运动后腰痛	症状
中毒性神经病	疾病
耳道堵塞	疾病
外阴象皮肿	疾病
湿肺	疾病
声调似小孩	症状
胸廓出口综合征	症状
肛内轻微隐痛坠胀或不适感	症状
肠道气囊肿症	疾病
外周围血淋巴细胞浆有空泡	症状
走动性自动症	症状
隐匿阴茎	疾病
肾小动脉有纤维梗死	症状
头部震颤	疾病
无痛性心肌梗死	症状
结直肠血管瘤	疾病
下肢久立时出现膨胀性剧烈疼痛	症状
声低	症状
丝状疣	疾病
铍中毒	疾病
脑肺吸虫病	疾病
微小病毒感染	疾病
脑动脉炎	疾病
颈椎后脱位	疾病
隐球菌病	疾病
腰腹酸沉	症状
鸡鸣样回声	疾病
唇甲色淡	症状
压迫瘘口试验	症状
局灶症状	症状
三角头畸形	症状
体象障碍	疾病
思维缓慢	症状
双侧肾内痛	疾病
失盐	疾病
硬脊膜下脓肿	疾病
耳内闭塞感	症状
关节囊损伤	症状
肺性肥大	症状
惧站立，喜依托	症状
绿菌门	细菌
氯乙烯中毒	疾病
小脑失调症	症状
血管性脊髓病	疾病
进行性肥厚性间质性神经炎	疾病
常染色体畸变	疾病
排尿前后膀胱区痛	症状
白蛉热	疾病
热伤神明	症状
胰胆管合流异常综合征	疾病
精冷不育	症状
失认症	症状
胆道蛔虫病与肝蛔虫病	疾病
痛性溃疡和渗出恶臭的黄绿色脓液	症状
色盲	疾病
腹股沟疼痛	症状
三氯乙烯中毒	疾病
碘甲亢	疾病
脑腱性黄瘤症	疾病
成人多囊肾	疾病
头皮痒	症状
心肌劳损	症状
巨吻棘头虫病	疾病
蛇伤	症状
常染色体隐性遗传病	疾病
氯丙烯中毒	疾病
颈部肌肉肿胀变硬	症状
色厥色脱	疾病
咳声低弱	症状
呼吸浅慢	症状
质粒	细菌
喜温膏按	症状
氯丁二烯中毒	疾病
呼吸气为酒味	症状
先天性耳前瘘管	疾病
鼻孔干疼	症状
美尼尔	疾病
咽异感症	症状
乳腺导管扩张症	疾病
眉弓疼痛	症状
寰枢椎脱位	疾病
咽喉如痹	症状
胎儿窘迫	症状
老年人无症状性心肌缺血	症状
丙烯酰胺中毒	疾病
双球菌	细菌
单纯性外阴阴道念珠菌病	疾病
创伤性鼻出血	疾病
颅狭症	症状
避孕后闭经综合征	症状
嗜酸性粒细胞性膀胱炎	疾病
红斑狼疮	疾病
滑膜黑染	症状
海绵肾	疾病
脊髓小脑变性症	症状
婴幼儿脐疝	疾病
食管损伤	疾病
肾性失镁	疾病
排精不畅	疾病
宫颈囊肿	疾病
获得性循坏抗凝物质增多综合征	疾病
多系统萎缩	疾病
左胸痛	症状
原发性肾小球肾炎	疾病
肛管狭窄	疾病
天冬氨酰葡萄糖胺尿症	疾病
兰伯特-伊顿综合征	疾病
肛门失禁	症状
筋骨懈堕	症状
允许细胞	病毒
拮抗剂	药物
复发性外阴阴道念珠菌病	症状
臂丛神经痛	疾病
甘露糖苷贮积症	疾病
特发性高嗜酸性细胞综合征	疾病
口角向外的放射性皱纹	症状
癌症	疾病
阿根廷出血热	疾病
腹胀	症状
骨折	疾病
药品	疾病
免疫缺陷	疾病
秋季腹泻	疾病
囊肿	疾病
吞咽困难	症状
呼吸道传染病	疾病
逆转录病毒	病毒
替比夫定	病毒
脂肪肝	疾病
奥司他韦	药物
掌跖脓疱病	疾病
天疱疮	疾病
肠病性肢端皮炎	疾病
疥疮	疾病
虱病	疾病
瘙痒	症状
疣	疾病
传染性软疣	疾病
寻常疣	疾病
中风	疾病
真性红细胞增多症	疾病
肺间质纤维化	疾病
肾小球肾炎	疾病
血小板减少性紫癜	疾病
蛔虫病	疾病
性功能	疾病
高血压	疾病
动脉硬化	疾病
急性肾盂肾炎	疾病
脑蛛网膜炎	疾病
全身弥漫性潮红	症状
呼吸微弱	症状
瑞列绦虫病	疾病
克-雅氏病性痴呆	疾病
原发性皮肤B细胞淋巴瘤	疾病
反复鼻出血	症状
智能减退	症状
外阴萎缩	疾病
流涎粘稠	症状
皮肤出现硬块	症状
慢性前列腺炎	疾病
阴道炎	疾病
前列腺炎	症状
消化不良	疾病
急性肠炎	疾病
胃痛	症状
直肠阴道瘘	症状
咯血	症状
哮喘	症状
猝死	疾病
妇科	疾病
前列腺肿瘤	疾病
剥脱性皮炎型药疹	症状
黄连素	药物
肢端肥大症	疾病
缺血性坏死	疾病
眼前冒火花或眼前闪光	症状
脐周疼痛	疾病
产后崩漏	症状
绿脓杆菌性肺炎	疾病
营养性贫血	疾病
老年性紫癜	疾病
小儿暑温	疾病
胶原病	疾病
乳发	疾病
不能转颈	症状
巨大血小板病	疾病
痰	症状
头皮松垂	症状
煤工尘肺	疾病
亚急性硬化性全脑炎	药物
咀嚼肌痉挛	疾病
荨麻疹	疾病
不可克制的饮酒冲动	症状
舍格伦综合征	疾病
原发性肾病综合征	疾病
人流后妇科病	疾病
泌尿生殖系滴虫病	疾病
子痰	疾病
职业病	疾病
食源性疾病	疾病
关节炎	疾病
肾动脉硬化	疾病
多囊肾	疾病
盲袢综合征	症状
五氯酚中毒	疾病
消炎药	药物
泰利霉素	药物
虹视	症状
睁眼困难	症状
失语	症状
骨炎	疾病
男科外伤	疾病
高催乳素血症	疾病
外伤后头痛	症状
脂瘤	疾病
可的松	疾病
老年性耳聋	疾病
慢性化脓性鼻窦炎	疾病
新生儿病理性黄疸	疾病
斜视	疾病
腰背痛	症状
脱髓鞘病	疾病
外阴瘙痒	症状
病毒	病毒
麻醉药	药物
耳后乳突水肿	症状
新生儿坏死性小肠结肠炎	疾病
圆形或卵圆形丘疹或结节	症状
锁喉痈	疾病
倦怠肢冷	症状
裂头绦虫病	疾病
口腔黏膜纤维化	疾病
淋巴管扩张	疾病
下颌骨骨折	疾病
儿童大便失禁	疾病
毛细血管扩张综合征	疾病
肾动脉狭窄	疾病
盐酸克仑特罗中毒	疾病
肾盂输尿管连接部梗阻	疾病
嗜皮菌病	疾病
乳房红肿热痛	疾病
小脑萎缩	疾病
第三腰椎横突综合征	疾病
小儿先天性卵巢发育不全	疾病
逼尿肌不稳定	症状
咽喉疼痛	症状
湿热证	症状
耳道异物	疾病
血管性血友病	疾病
完谷不化	疾病
肾脏疾病伴发的精神障碍	症状
癣菌疹	疾病
手指冻肿	症状
肢萎	症状
柞蚕蛹脑病	疾病
POEMS综合征	疾病
精囊缩小	症状
固氮菌	细菌
氯气中毒	疾病
窒息性气体中毒	疾病
喜树碱	药物
口腔溃疡	疾病
制酸剂	药物
牙髓病	疾病
精神分裂症	疾病
慢性咽炎	疾病
胁痛	症状
带下病	疾病
神经衰弱	症状
乳腺增生	疾病
矽肺	疾病
健忘	症状
坐骨神经痛	疾病
异位胰腺	症状
毛滴虫病	疾病
鞭虫病	疾病
小儿肺炎	疾病
月经紊乱	疾病
腰疼	症状
贲门失弛缓症	疾病
角膜营养不良	疾病
进行性肌营养不良症	疾病
阿霉素	药物
急性腹膜炎	疾病
多发性硬化症	疾病
牙周炎	疾病
下肢静脉曲张	疾病
牙周病	疾病
绝经后出血	症状
乳腺导管瘤	疾病
慢性喉炎	疾病
跖反射伸性	症状
颅骨纤维异常增生症	疾病
下巴关节疼	疾病
三硝基甲苯中毒	疾病
五酯微丸	药物
咳喘	症状
眩晕	疾病
一过性意识蒙眬	症状
外周血管减少	症状
青盲病	疾病
克山病	疾病
药物性狼疮	疾病
高脂血症	疾病
浮霉菌门	细菌
外耳道异物	疾病
眼肌麻痹	症状
链球菌	细菌
脏寒	症状
先天性肥厚性幽门狭窄	疾病
预激综合征	症状
病毒性心肌炎	病毒
甲状腺结节	疾病
结节性红斑	疾病
细菌性肝脓肿	细菌
细菌性阴道病	疾病
继发性青光眼	症状
结肠过敏症	疾病
结节性甲状腺肿	疾病
细菌性脑膜炎	疾病
解脲支原体	疾病
根尖周病	疾病
肌无力	疾病
胎儿宫内窘迫	症状
龙眼肉	药物
小脑性共济失调	症状
肺热咳嗽	症状
铍病	疾病
细菌性咽扁桃体炎	症状
全身皮肤粗厚	疾病
喉部刺痛	症状
内脏痛	症状
脑猪囊尾蚴病	疾病
尿胆原排泻增加	症状
晶状体蛋白逸出	症状
噪声病	疾病
上半身热刺激性多汗	疾病
肠血管瘤	疾病
口腔灶性上皮增生	疾病
胸腰驼背	疾病
骶髂关节疼痛	症状
继发性早泄	疾病
中毒性肝病	疾病
口腔毛滴虫病	症状
停止排气	症状
黑子	疾病
手机依赖症	疾病
透明丝孢霉病	疾病
类风湿性关节炎肾损害	疾病
食管白斑	疾病
尿道流出分泌物	疾病
梗阻性肾病	疾病
复聪现象	症状
特发性震颤	疾病
视野缺损	疾病
肛周炎	疾病
肌筋膜炎	症状
食管痉挛	疾病
烧心	症状
输尿管扩张	症状
先兆流产	疾病
幽闭恐惧症	症状
恶心	症状
手足皲裂	疾病
毒性弥漫性甲状腺肿	疾病
失盐性肾炎	疾病
纵沟短	疾病
海鲜过敏	疾病
口周皮炎	疾病
西替利嗪	药物
结核性胸膜炎	疾病
慢性咳嗽	疾病
垂体微腺瘤	症状
脑萎缩	疾病
脑炎后遗症	疾病
络活喜	药物
甲状腺囊肿	症状
乳头状腺癌	疾病
漏斗胸	疾病
蚁走感	症状
遗传性共济失调	疾病
双手轮替动作笨拙	症状
垂腕	症状
指甲很短	症状
末指短小向内弯曲或只有两指节	症状
蝶形骨折	症状
慢性酒精中毒	症状
强心药	药物
腹鸣	症状
胫前黑斑	症状
小腿腓部肌肉疼痛和压痛	疾病
下蹲困难	疾病
腱或腱止点处增粗或钙化	症状
下肢红斑结节	疾病
腿外侧质软半球形包块	症状
小腿和踝关节周围的紫红色瘀斑	疾病
腿前内侧出现感觉异常	症状
拇趾与二趾趾间距大	症状
小腿酸痛	症状
安眠药	药物
虚烦失眠	症状
X综合征	症状
土元	疾病
氯吡格雷	药物
静脉曲张性溃疡	疾病
抗高血压药	药物
心前区疼痛	症状
麻痹性痴呆	症状
咯血病	疾病
白天不自觉地将牙咬紧	疾病
牙齿发酸	症状
急性贫血	症状
Reiter综合征	疾病
下疳	疾病
海绵窦血栓性静脉炎	疾病
血尿	症状
血汗症	疾病
酒精中毒	疾病
神经外科	疾病
嗜热生物	细菌
酸杆菌门	细菌
比阿培南	药物
适应症	疾病
坏疽	症状
肌肉痛	症状
输血反应	疾病
口腔粘膜病	疾病
硝基呋喃类抗菌药物	药物
肥胖症	疾病
米氮平	药物
腋区疼痛	症状
色汗症	疾病
阴道黏膜膨胀	症状
丙戊酸	药物
营养药	药物
新生儿心肌炎	疾病
白化病	疾病
面部蝶形红斑	症状
肾皮质脓肿	疾病
红眼	症状
润喉片	药物
继发性血管炎	疾病
饮水呛咳	症状
胆管梗阻	疾病
阑尾周围脓肿	疾病
血管病	疾病
结核中毒症状	症状
阿司咪唑	药物
腹痛下痢	症状
黑尿症	疾病
皮肤卟啉病	疾病
角膜糜烂	症状
肠子宫内膜异位	症状
倍他乐克	药物
脸颊出现红血丝	症状
肺癌胸水	症状
止咳	症状
真菌性鼻窦炎	疾病
皮肤龟裂	症状
病因辨证	疾病
纤维支气管镜检查	疾病
股外侧皮神经炎	疾病
脑白质萎缩	症状
顽固性便秘	疾病
水林佳	药物
粘膜有粘着性白斑	症状
恶心与呕吐	症状
日射病	疾病
脑衰弱综合征	症状
疤痕体质	症状
衰弱	疾病
脘痞	症状
白三烯受体拮抗剂	药物
思维紊乱	疾病
红蝴蝶疮	疾病
纳布啡	药物
头风病	疾病
帕金森病	疾病
胃粘膜增粗	疾病
艾司唑仑	药物
美沙酮	症状
遗传性异常纤维蛋白原血症	疾病
自闭症	疾病
余甘子	药物
博思清	药物
牛皮癣性关节炎	疾病
润洁	症状
基础疾病	疾病
爱脉朗	药物
吸入麻醉药	药物
贫血	疾病
减压病	疾病
志苓胶囊	症状
脂质沉积症	疾病
日夜百服咛	药物
牙周宁	药物
心肌病	疾病
辅舒酮	药物
嗜睡	疾病
龋齿	疾病
干燥综合征	疾病
