微生物	细菌
假单胞菌	细菌
热微菌门	细菌
绿弯菌门	细菌
三域系统	细菌
产金菌门	细菌
梭杆菌门	细菌
硫细菌	细菌
放线菌门	细菌
拟杆菌门	细菌
牙菌斑	疾病
性菌毛	细菌
真细菌	细菌
志贺氏菌属	细菌
化脓性链球菌	细菌
幽门螺杆菌	细菌
疣微菌门	细菌
益生菌	细菌
腐生菌	细菌
纤维杆菌门	细菌
衣原体门	细菌
脱铁杆菌门	细菌
革兰阳性菌	细菌
蓝细菌	细菌
热脱硫杆菌门	细菌
芽单胞菌门	细菌
网团菌门	细菌
革兰阴性菌	疾病
酸杆菌门	细菌
热袍菌门	细菌
细菌发电	细菌
链球菌属	细菌
变形杆菌食物中毒	疾病
葡萄球菌性食物中毒	疾病
菌落	细菌
隐球菌	细菌
乳杆菌	细菌
根瘤	细菌
嗜盐菌	细菌
烃类发酵	细菌
固氮细菌	细菌
苏云金杆菌	细菌
硫磺细菌	细菌
德克斯氏菌属	细菌
泰乐菌素	疾病
菌株	细菌
致病性大肠杆菌	细菌
自生固氮菌	细菌
链球菌感染	疾病
有益菌	细菌
非结核分枝杆菌病	疾病
耐药菌	细菌
耐药菌	疾病
固氮菌科	细菌
土壤放线菌	细菌
T2噬菌体	细菌
急性细菌性痢疾	疾病
固氮菌	细菌
滑行细菌	细菌
好氧性细菌	细菌
硝化杆菌	细菌
衣鞘	细菌
好氧细菌	细菌
主动运输	细菌
细菌性感染	疾病
流感嗜血杆菌	细菌
转化子	细菌
性纤毛	细菌
菌毛	细菌
前噬菌体	细菌
多粘菌素B	疾病
小单孢菌属	细菌
霉菌性膀胱炎	疾病
动性球菌属	细菌
微球菌科	细菌
藤黄微球菌	细菌
念珠菌感染	疾病
侧孢短芽孢杆菌	细菌
菌群失调	疾病
芽孢杆菌科	细菌
地衣芽孢杆菌	细菌
蜡样芽孢杆菌	细菌
氧化亚铁硫杆菌	细菌
土壤杆菌属	细菌
叶杆菌属	细菌
细菌外毒素	疾病
白粉菌	细菌
梭状芽孢杆菌	细菌
沙门氏菌	细菌
硝化细菌	细菌
霍乱肠毒素	细菌
海洋细菌	细菌
脆弱拟杆菌	细菌
脆弱类杆菌	细菌
产气荚膜梭菌	细菌
厌氧菌感染	疾病
产气荚膜杆菌	细菌
破伤风梭菌	细菌
双球菌	细菌
皮炎芽生菌	疾病
绿脓杆菌	细菌
新型隐球菌性脑膜炎	疾病
单纯性外阴阴道念珠菌病	疾病
乳酸细菌	细菌
肺炎杆菌	疾病
梭菌属	细菌
醋酸杆菌	细菌
假单胞菌属	细菌
鼠伤寒沙门氏菌	细菌
黄色短杆菌	细菌
皮肤真菌病	疾病
细菌学	细菌
微球菌属	细菌
红螺菌	细菌
拟杆菌	细菌
短杆菌属	细菌
棒状杆菌属	细菌
肺炎球菌多糖疫苗	疾病
流感杆菌	细菌
细菌性心内膜炎	疾病
巴氏杆菌	细菌
荚膜组织胞浆菌病	疾病
结核菌素试验	疾病
芽孢杆菌	细菌
真菌病	疾病
马铃薯软腐病	细菌
百日咳杆菌	细菌
亚急性细菌性心内膜炎	疾病
微需氧菌	细菌
沙门氏菌病	疾病
单核吞噬细胞	细菌
嗜肺军团菌	细菌
志贺菌属	细菌
志贺菌属	疾病
芽生菌病	疾病
硫化细菌	细菌
军团菌感染	疾病
红环菌属	细菌
弧菌属	细菌
兼性细菌	细菌
弧菌科	细菌
沃林氏菌属	细菌
变形杆菌属	细菌
螺杆菌属	细菌
伯克霍尔德菌	细菌
弯曲菌属	细菌
葡萄球菌属	疾病
沙门氏菌属	细菌
葡萄球菌	细菌
葡萄球菌	疾病
棒状杆菌	细菌
草绿色链球菌	细菌
A族链球菌	细菌
肺炎链球菌	细菌
侵袭性酶	细菌
无乳链球菌	细菌
链球菌溶血素	疾病
化能合成细菌	细菌
根瘤菌	细菌
反硝化细菌	细菌
生物污染物	细菌
肠球菌	细菌
肠球菌	疾病
卡他莫拉菌	细菌
脑膜炎奈瑟菌	细菌
肺炎克雷伯杆菌	细菌
肺炎克雷伯杆菌	疾病
不动杆菌属	细菌
不动杆菌属	疾病
抗菌药物	疾病
耐甲氧西林金黄色葡萄球菌	细菌
耐甲氧西林金黄色葡萄球菌	疾病
奈瑟菌属	细菌
奈瑟菌属	疾病
炭疽杆菌	细菌
甲烷杆菌属	细菌
甲烷细菌	细菌
四联球菌	细菌
微球菌	细菌
细菌感染	疾病
保加利亚乳杆菌	细菌
乳杆菌属	细菌
屎肠球菌	细菌
李斯特菌	细菌
李斯特菌	疾病
科赫法则	细菌
非结核分枝杆菌	细菌
非结核分枝杆菌	疾病
分枝杆菌属	细菌
冬孢子	细菌
葡萄球菌感染	细菌
葡萄球菌感染	疾病
菌物	疾病
伞菌	细菌
念珠菌性间擦疹	疾病
慢性皮肤粘膜念珠菌病	疾病
念珠菌性败血症	疾病
粘膜念珠菌病	疾病
霍乱弧菌	细菌
肺念珠菌病	疾病
慢性黏膜皮肤念珠菌病	疾病
念珠菌性阴道炎	疾病
念珠菌性龟头炎	疾病
壶菌病	疾病
兼性寄生菌	细菌
砖火丝菌	细菌
毛癣菌属	疾病
白色链霉菌	细菌
米根霉	细菌
细胞壁	细菌
乳酸链球菌素	细菌
细菌战	细菌
嗜血杆菌属	细菌
抑菌剂	细菌
抑菌剂	疾病
纹枯病	细菌
真菌性皮肤病	疾病
蛭弧菌	细菌
非淋菌性尿道炎	疾病
非淋球菌性尿道炎	疾病
加特纳菌阴道炎	疾病
黏菌	细菌
细菌性食物中毒	疾病
细菌性阴道病	疾病
肺真菌病	疾病
军团菌肺炎	疾病
深红沙雷氏菌	细菌
粘质沙雷氏菌	细菌
克雷伯氏菌	细菌
沙雷氏菌属	细菌
克雷伯氏菌属	细菌
爱德华氏菌属	细菌
枯草芽孢杆菌	细菌
厌氧菌	细菌
厌氧菌	疾病
柠檬酸杆菌属	细菌
耶尔森氏菌属	细菌
黄曲霉菌	细菌
细菌性结膜炎	疾病
寡聚核苷酸	细菌
部分结合	细菌
温和性噬菌体	细菌
木薯细菌性枯萎病	细菌
创伤弧菌感染	疾病
创伤弧菌	细菌
中国普通微生物菌种保藏管理中心	细菌
拟态弧菌	细菌
霍利斯弧菌	细菌
球杆菌	细菌
鼠疫耶尔森菌	细菌
李斯特氏菌属	细菌
丹毒丝菌属	细菌
醋杆菌属	细菌
肠球菌属	细菌
羊布氏杆菌病	疾病
梭杆菌属	细菌
革兰氏阳性菌	细菌
革兰氏阳性菌	疾病
氧化硫硫杆菌	细菌
生物冶金	细菌
自溶素	细菌
拟杆菌属	疾病
细菌性疾病	疾病
猪霍乱沙门氏菌	疾病
螺菌属	细菌
急性菌痢	疾病
慢性细菌性痢疾	疾病
红螺菌属	细菌
芽孢杆菌属	细菌
绿菌属	细菌
氢细菌	细菌
葡萄球菌食物中毒	疾病
盒状嗜盐细菌	细菌
厌氧生物	细菌
不动杆菌	细菌
非发酵菌	细菌
马克·皮特	细菌
嗜冷菌	细菌
细菌总数	细菌
大肠菌群	细菌
非典型分枝杆菌	细菌
发光细菌	细菌
内生菌	细菌
粪产碱菌	细菌
弗兰克氏菌	细菌
埃希菌属	疾病
诺卡氏菌科	疾病
布鲁菌属	细菌
布鲁菌属	疾病
放线菌科	细菌
乙型溶血性链球菌	细菌
嗜盐富饶菌属	细菌
着色菌属	细菌
肠出血性大肠杆菌	疾病
耳菌	疾病
脱氮硫杆菌	细菌
猪梭菌性肠炎	疾病
巴氏杆菌属	细菌
巴氏杆菌属	疾病
牛巴氏杆菌病	疾病
巴氏杆菌病	疾病
革兰氏阴性菌	细菌
革兰氏阴性菌	疾病
牙菌膜	疾病
隐球菌脑膜炎	疾病
医用酒精	细菌
真菌性肠炎	疾病
空肠弯曲菌肠炎	疾病
蟾蜍分枝杆菌	细菌
曲霉菌病	疾病
芝麻细菌性角斑病	细菌
嗜水气单胞菌	细菌
变形菌门	细菌
沙门氏菌属感染	疾病
细菌性肝脓肿	疾病
游动放线菌	细菌
硅酸盐细菌	细菌
爱德华氏菌	细菌
刺激隐核虫	细菌
明串珠菌	细菌
孢子丝菌病	疾病
光细菌纲	细菌
痤疮丙酸杆菌	细菌
金黄色葡萄球菌	细菌
孔祥复	细菌
偶发分枝杆菌	细菌
海分枝杆菌	细菌
痰菌	疾病
放线菌病	疾病
大肠杆菌病	疾病
土拉杆菌病	疾病
链球菌咽喉炎	疾病
球形红假单胞菌	细菌
志贺菌病	疾病
菌群失调症	疾病
产气肠杆菌	细菌
淋菌性结膜炎	疾病
肺曲菌病	疾病
嗜血杆菌感染	疾病
细菌性肺炎	疾病
流感嗜血杆菌感染	疾病
多头绒泡菌	细菌
细菌生物被膜	细菌
普雷沃氏菌属	细菌
乳酸杆菌	细菌
双歧杆菌	细菌
绿屈挠菌属	细菌
丝状杆菌属	细菌
嗜甲基菌属	细菌
黄杆菌属	细菌
氢杆菌属	细菌
类芽孢杆菌属	细菌
暗网菌属	细菌
甲基杆菌属	细菌
棒杆菌属	细菌
柄杆菌属	细菌
白喉杆菌	细菌
白喉杆菌	疾病
热球菌属	细菌
嗜热放线菌	细菌
阪崎肠杆菌	细菌
水稻细菌性褐斑病	细菌
嗜压细菌	细菌
假单孢杆菌	疾病
奈瑟氏球菌属	细菌
奈瑟氏球菌属	疾病
无色杆菌	细菌
硫酸盐还原细菌	细菌
枝动菌属	细菌
肠道菌群	细菌
芽原基	细菌
无菌性炎症	疾病
新型隐球菌脑膜炎	疾病
中毒型细菌性痢疾	疾病
小儿其他沙门菌感染	疾病
深部真菌病	疾病
细菌性睾丸炎	细菌
细菌性睾丸炎	疾病
霉菌性外阴炎	疾病
加特纳菌性阴道炎	疾病
肺炎链球菌肺炎	疾病
链球菌	细菌
粉尘螨	细菌
真菌性肺炎	疾病
细菌感染性口炎	疾病
上海分枝杆菌	细菌
舌菌	疾病
非芽孢性厌氧菌感染	细菌
非芽孢性厌氧菌感染	疾病
表皮葡萄球菌	细菌
表皮葡萄球菌	疾病
乳酸菌	细菌
热网菌属	细菌
产甲烷菌属	细菌
极端嗜热菌	细菌
甲烷微菌属	细菌
嗜极菌	细菌
肽聚糖	细菌
变形菌属	细菌
古生菌	细菌
甲烷杆菌	细菌
硫化叶菌	细菌
甲烷叶菌属	细菌
甲烷球菌属	细菌
细菌域	细菌
嗜热链球菌	细菌
嗜酸乳杆菌	细菌
大肠杆菌	细菌
大肠杆菌	疾病
铁细菌	细菌
芽孢	细菌
单细胞生物	细菌
结核分枝杆菌	疾病
嗜热菌	细菌
细菌界	细菌
真菌感染	疾病
链霉菌	细菌
原核生物界	细菌
基因工程菌	疾病
子囊菌亚门	细菌
白色念球菌	疾病
原核	细菌
子囊菌	细菌
丝状菌	细菌
布鲁氏菌病	疾病
细菌性脑膜炎	疾病
肉毒杆菌	细菌
γ-变形菌纲	细菌
埃希氏菌属	细菌
结核杆菌	细菌
肠杆菌	细菌
肠杆菌科	细菌
大肠杆菌噬菌体	疾病
细菌毒素	细菌
螺旋菌	细菌
弧菌	细菌
鞭毛蛋白	细菌
伤寒杆菌	细菌
伤寒杆菌	疾病
鼠疫杆菌	细菌
嗜冷细菌	细菌
微生物学	细菌
厚壁菌门	细菌
硝化螺旋菌门	细菌
异常球菌-栖热菌门	细菌
细菌电池	细菌
菌血症	疾病
布氏杆菌	细菌
产水菌门	细菌
绿菌门	细菌
细菌细胞壁	细菌
细菌素	细菌
流行性乙型脑炎	疾病
恙虫	病毒
恙虫	疾病
乙型肝炎疫苗	疾病
传染性支气管炎	疾病
恶性葡萄胎	疾病
乳癌	疾病
胸水	疾病
镜检	疾病
月经周期	疾病
孪生子	疾病
髓鞘	疾病
立克次氏体病	疾病
红细胞沉降率	疾病
肾脏衰竭	疾病
镜下血尿	疾病
溶血	疾病
骨髓细胞	疾病
斑点热	疾病
汗水	疾病
氧分压	疾病
红细胞沉降	疾病
鱼口	疾病
睾丸素	疾病
咀嚼	疾病
大脑结构	疾病
左心室	疾病
诊断试剂盒	疾病
一般反应	疾病
立克次体病	疾病
破伤风类毒素	疾病
炭疽活疫苗	疾病
血清流行病学	疾病
预防传染病	疾病
黄热病疫苗	疾病
CD34	疾病
乙型脑炎疫苗	疾病
甲型血友病	疾病
霍乱疫苗	疾病
乙肝表面抗体	疾病
Q热	疾病
血小板	疾病
红疹	疾病
小三阳	疾病
大三阳	疾病
淋巴细胞杂交瘤	疾病
HGPRT	疾病
脑血栓	疾病
肉毒素	病毒
肉毒素	疾病
慢性肉芽肿病	疾病
落基山斑疹伤寒	疾病
联合免疫缺陷病	疾病
Bruton综合症	疾病
机会性感染	疾病
严重联合免疫缺陷病	疾病
遗传性	疾病
原发性	疾病
自身免疫疾病	疾病
继发性	疾病
移植物抗白血病效应	疾病
骨髓移植	疾病
汉赛巴通体	细菌
汉赛巴通体	疾病
抗体效价	疾病
关节僵硬	疾病
营养失调	疾病
寄生虫病	疾病
肉芽	疾病
继发反应	疾病
毒血症	疾病
脊髓神经	疾病
湿疹样	疾病
髓鞘碱性蛋白	疾病
体虱	疾病
T细胞功能缺陷	疾病
实验性变态反应性脑脊髓炎	疾病
皮损	疾病
肉芽肿	疾病
鳞屑	疾病
甲状腺炎	疾病
细胞超微结构	疾病
天花	疾病
天花	疾病
恙虫病	疾病
天花	疾病
天花	疾病
天花	疾病
排泄系统	疾病
巨球蛋白血症	疾病
单克隆免疫球蛋白血症	疾病
血清蛋白电泳	疾病
慢性贫血	疾病
病机	疾病
积聚	疾病
蚤	疾病
白崩	疾病
心脏神经节	疾病
周围神经	疾病
冠瘿瘤	疾病
骨髓活检	疾病
色素性荨麻疹	疾病
脱落细胞	疾病
肥大细胞白血病	疾病
酸性磷酸酶	疾病
软化病	疾病
鼠型斑疹伤寒	疾病
运动器官	疾病
软骨板	疾病
反复自然流产	疾病
百浪多息	疾病
阿米巴原虫病	疾病
昏睡病	疾病
苯妥英	疾病
阿达木单抗	疾病
甲状腺球蛋白	疾病
肺功能检查	疾病
恙虫病立克次体	疾病
气道阻力	疾病
咽干	疾病
急性气管炎	疾病
痰多	疾病
肺气不宣	疾病
叶黄素	疾病
自主神经功能失调	疾病
细嚼慢咽	疾病
脾肺两虚	疾病
痰量	疾病
温养	疾病
咳痰	疾病
啰音	疾病
哮鸣音	疾病
气道反应性	疾病
精子	疾病
雀斑	疾病
跟腱	疾病
易感人群	疾病
风寒型感冒	疾病
体温	疾病
并发症	疾病
身体机能	疾病
心肺功能	疾病
骨质软化	疾病
心率	疾病
生理平衡	疾病
腰间盘	疾病
运动过量	疾病
人畜共患疾病	疾病
人流感	疾病
路易小体	疾病
意识障碍	疾病
肢端肥大症	疾病
革兰氏染色	疾病
湿咳	疾病
恶风	疾病
鼻卡他	疾病
脑电图	疾病
尿失禁	疾病
医源性感染	疾病
重感冒	疾病
萎缩症	疾病
人脑	疾病
痒病	疾病
疼痛感	疾病
丘脑	疾病
眼科	疾病
禽流行性感冒	病毒
禽流行性感冒	疾病
接种率	疾病
抽搐	疾病
基因重配	疾病
高致病性禽流感	疾病
鸡瘟	疾病
高危人群	疾病
慢性非传染性疾病	疾病
流行病	疾病
公共卫生	疾病
大脑皮质	疾病
人格改变	疾病
大脑萎缩	疾病
神经系统变性疾病	疾病
重度联合免疫缺陷病	疾病
器官移植技术	疾病
脑组织	疾病
黑尿病	疾病
营养支持	疾病
颅底肿瘤	疾病
脑内血肿	疾病
动静脉畸形	疾病
锥体外系疾病	疾病
鸡霍乱	疾病
周围神经系统	疾病
室管膜瘤	疾病
小脑扁桃体下疝畸形	疾病
脑干肿瘤	疾病
血管畸形	疾病
大脑半球	疾病
髓母细胞瘤	疾病
脑室	疾病
颅缝早闭	疾病
动脉硬化	疾病
脑动静脉畸形	疾病
外科学	疾病
睡眠障碍	疾病
神经内分泌肿瘤	疾病
瘤	疾病
癌肉瘤	疾病
嗜酸细胞	疾病
腺癌	疾病
小细胞癌	疾病
胆固醇	疾病
平滑肌肉瘤	疾病
纤维肉瘤	疾病
生殖细胞瘤	疾病
恶性神经鞘瘤	疾病
恶性纤维组织细胞瘤	疾病
胸腺类癌	疾病
眼球	疾病
家牛	疾病
传导束	疾病
脑神经核	疾病
输血	疾病
动眼神经核	疾病
三叉神经	疾病
肌张力	疾病
肝区隐痛	疾病
胃酸缺乏	疾病
胃镜检查	疾病
不典型增生	疾病
潜血	疾病
神经病	疾病
甲状腺疾病	疾病
记忆障碍	疾病
额叶	疾病
终丝	疾病
腰椎	疾病
酗酒	疾病
小胶质细胞	疾病
纹状体	疾病
脑型疟疾	疾病
神经上皮细胞	疾病
糖原贮积病	疾病
脑血管疾病	疾病
自主神经系统	疾病
心跳	疾病
铊中毒	疾病
呼吸中枢	疾病
巴比妥类中毒	疾病
杏仁核	疾病
金属中毒	疾病
分泌腺	疾病
基底神经节	疾病
肉毒中毒	疾病
脂质贮积病	疾病
化脓性脑膜炎	疾病
连合纤维	疾病
慢性酒精中毒	疾病
脑神经	疾病
流行性胸痛	疾病
颅腔	疾病
嗜铬细胞	疾病
脑	疾病
铅中毒	疾病
粘多糖病	疾病
内脏神经	疾病
躯体神经系统	疾病
委内瑞拉马脑炎	疾病
婴儿急疹	疾病
非特异性感染	疾病
疱疹	疾病
单核细胞增多症	疾病
心动过速	疾病
性生活	疾病
原虫病	疾病
血小板减少症	疾病
病因治疗	疾病
特异性感染	疾病
预后不良	疾病
溃疡	疾病
甲状腺	疾病
感染性心内膜炎	疾病
肾功能不全	疾病
C-反应蛋白	疾病
呼吸肌	疾病
盆腔	疾病
向心性肥胖	疾病
内分泌紊乱	疾病
脑垂体萎缩	疾病
黄体	疾病
性欲减退	疾病
颅内压	疾病
肢端肥大	疾病
颅中窝	疾病
钩端螺旋体	疾病
玫瑰糠疹	疾病
外展神经	疾病
手指麻木	疾病
乳腺增生症	疾病
促黑素细胞激素	疾病
垂体激素	疾病
第三脑室	疾病
生长激素细胞腺瘤	疾病
促卵泡激素	疾病
腺垂体	疾病
动眼神经麻痹	疾病
甲状腺增生	疾病
侏儒症	疾病
性功能	疾病
蝶鞍	疾病
性腺功能低下	疾病
垂体门脉系统	疾病
催乳素细胞腺瘤	疾病
恶性垂体瘤	疾病
视交叉	疾病
脉络膜炎	疾病
皮质醇	疾病
阴痿	疾病
祛邪	疾病
黑斑	疾病
盗汗	疾病
尘螨	疾病
疥螨	疾病
蜱叮咬	疾病
立克次体痘	疾病
蠕形螨病	疾病
网膜炎	疾病
过敏性皮肤	疾病
莱姆病	疾病
兔热病	疾病
新疆出血热	疾病
皮脂腺	疾病
肛门	疾病
蛔虫	疾病
粪类圆线虫	疾病
MCAB	疾病
症状学	疾病
气管	疾病
流质食物	疾病
眼药水	疾病
脱皮	疾病
赤子爱胜蚓	疾病
流行性角膜结膜炎	疾病
过劳死	疾病
强心苷	疾病
食欲不振	疾病
流产	疾病
胆管炎	疾病
充血	疾病
脓病	疾病
慢性麻痹病	疾病
淋巴管炎	疾病
流涕	疾病
自限性	疾病
畏寒	疾病
咽痛	疾病
喷嚏	疾病
颅内压增高	疾病
慢性粒细胞白血病	疾病
心包积液	疾病
急性白血病	疾病
骨髓增生异常综合征	疾病
肛周脓肿	疾病
感染性物质	疾病
猫白血病	疾病
猫肉瘤	疾病
小鼠肉瘤	疾病
牛地方流行性白血病	病毒
牛地方流行性白血病	疾病
角膜混浊	疾病
瘤胃臌气	疾病
去甲肾上腺素	疾病
牛恶性卡他热	疾病
胃酸	疾病
血清学诊断	疾病
抗O	疾病
口蹄疫疫情	疾病
牛瘟	疾病
脱色	疾病
急性肝坏死	疾病
化疗	疾病
围产期	疾病
总胆固醇	疾病
磷代谢	疾病
梅毒螺旋体	疾病
脂蛋白合成	疾病
盲肠	疾病
高密度脂蛋白胆固醇	疾病
锥虫属	疾病
腹膜	疾病
利什曼病	疾病
仔猪	疾病
阴囊象皮肿	疾病
丝虫感染	疾病
精索炎	疾病
食物中毒	疾病
淋巴水肿	疾病
阴蒂	疾病
阴唇	疾病
班氏丝虫病	疾病
乳糜血	疾病
淋巴管阻塞	疾病
迷走神经兴奋	疾病
马来丝虫病	疾病
栓塞	疾病
淋巴管扩张	疾病
急性炎症	疾病
夜现周期性	疾病
盘尾丝虫病	疾病
疟疾复发	疾病
超高热	疾病
再燃	疾病
恶性疟疾	疾病
一期梅毒	疾病
输血感染	疾病
三日疟	疾病
胰岛B细胞	疾病
近视眼	疾病
器官衰竭	疾病
腋窝	疾病
静脉回流	疾病
血浆胶体渗透压	疾病
瓣膜	疾病
乳糜胸	疾病
三期梅毒	疾病
乳糜腹	疾病
颈静脉	疾病
革兰氏染色阴性	疾病
脑灰质	疾病
微循环障碍	疾病
发病率	疾病
精神症状	疾病
焦痂	疾病
地方性斑疹伤寒	疾病
皮肤溃疡	疾病
二期梅毒	疾病
虱病	疾病
脑血管障壁	疾病
心室	疾病
落矶山斑点热	疾病
季节性	疾病
人兽共患病	疾病
结核	疾病
化脓性皮肤病	疾病
支原体肺炎	疾病
热病	疾病
酸碱平衡紊乱	疾病
肺螨症	疾病
肠螨症	疾病
皮肤点刺试验	疾病
尘螨过敏	疾病
肺部感染	疾病
十二指肠	疾病
普鲁卡因	疾病
化学消毒	疾病
翻转作用	疾病
羊膜	疾病
子宫内膜	疾病
职业病	疾病
维生素缺乏症	疾病
甲状腺机能亢进症	疾病
非水溶性纤维	疾病
三酸甘油脂	疾病
心脑血管	疾病
叶酸	疾病
猪蛔虫	疾病
可的松	疾病
软化灶	疾病
昏迷	疾病
脑膜炎	疾病
发绀	疾病
外伤	疾病
可溶性膳食纤维	疾病
膀胱三角	疾病
精子发生	疾病
精囊炎	疾病
龟头	疾病
捐精	疾病
死精症	疾病
无精症	疾病
性欲	疾病
生精上皮	疾病
弱精	疾病
前列腺液	疾病
精子减少症	疾病
人工受精	疾病
射精	疾病
性兴奋	疾病
第二性征	疾病
宫颈粘液	疾病
补锌	疾病
尿道海绵体	疾病
输精管	疾病
精子计数	疾病
排卵期	疾病
激肽释放酶	疾病
勃起	疾病
精子库	疾病
酸性食物	疾病
主动脉瓣关闭不全	疾病
少精症	疾病
燥湿	疾病
肛周肿瘤	疾病
蛔虫性肠梗阻	疾病
空气负离子	疾病
红细胞生成性原卟啉病	疾病
易感者	疾病
白喉病	疾病
呼吸道阻塞	疾病
妊娠	疾病
病死率	疾病
百白破三联疫苗	疾病
喉喑	疾病
尿常规	疾病
雌二醇	疾病
交叉保护作用	病毒
交叉保护作用	疾病
高血糖素	疾病
舌扁桃体炎	疾病
病例	疾病
听觉	疾病
神经兴奋	疾病
氨中毒	疾病
乳酸酸中毒	疾病
丙氨酸氨基转移酶	疾病
口服葡萄糖耐量试验	疾病
药物剂型	疾病
假阳性	疾病
疹子	疾病
酵母铬	疾病
氨基糖苷类抗生素	疾病
人体九大系统	疾病
应激	疾病
弱阳性	疾病
类丹毒	疾病
骨炎	疾病
腹膜透析	疾病
化脓性关节炎	疾病
急性化脓性脑膜炎	疾病
滤泡上皮细胞	疾病
口腔溃疡	疾病
慢性咽喉炎	疾病
疱锈病	疾病
环丝氨酸	疾病
六郁	疾病
痰郁	疾病
湿郁	疾病
血郁	疾病
气郁	疾病
热郁	疾病
胆	疾病
终傅	疾病
锌缺乏病	疾病
堕胎	疾病
颌骨	疾病
过敏体质	疾病
创面	疾病
萎缩	疾病
氟骨症	疾病
中枢神经障碍	疾病
士的宁	疾病
棉酚	疾病
有机磷	疾病
鱼胆	疾病
垂直传播	疾病
毒蘑菇	疾病
肉毒毒素	疾病
贮积症	疾病
恶性疟原虫	疾病
p53基因	疾病
脑病	疾病
跌打损伤	疾病
运动	疾病
运动	疾病
聂文涛	疾病
白领	疾病
收敛	疾病
基础代谢	疾病
体力活动	疾病
粘液瘤	疾病
安全等级	疾病
急性传染病	疾病
便溏	疾病
拇趾	疾病
产后痉病	疾病
高热惊厥	疾病
小儿高热	疾病
子痫	疾病
扭转痉挛	疾病
肝瘟	疾病
皮肤病	疾病
滋阴熄风	疾病
强直性痉挛	疾病
项强	疾病
心烦失眠	疾病
清热解毒	疾病
咽喉	疾病
角弓反张	疾病
暑温	疾病
产后痉	疾病
不随意运动	疾病
外感风寒	疾病
癫痫大发作	疾病
头痛眩晕	疾病
实验室检查	疾病
脑痨	疾病
肝厥	疾病
尿素氮	疾病
白色假丝酵母	疾病
脉弦细	疾病
百会疽	疾病
疾病负担	疾病
上皮样细胞	疾病
郭霍现象	疾病
脑脊液培养	疾病
肺外结核	疾病
慢性淋巴结炎	疾病
吸毒	疾病
灰黄霉素	疾病
下呼吸道	疾病
阿米卡星	疾病
心包	疾病
新城疫	疾病
鸡冠	疾病
脓液	疾病
脓疱	疾病
鸦片	疾病
西医	疾病
羊痘	疾病
黄曲霉毒素	疾病
伦敦大瘟疫	疾病
艾斯伯格症候群	疾病
超短波	疾病
人体生殖系统	疾病
畏光	疾病
烂鳃病	疾病
疾病	疾病
霉病	疾病
日本血吸虫	疾病
肠道	疾病
血管系	疾病
华支睾吸虫	疾病
空腹	疾病
口臭	疾病
阴虚内热	疾病
胃寒呕吐	疾病
食道癌	疾病
抗生素	疾病
根腐病	疾病
软腐病	疾病
小儿疟疾	疾病
噤口痢	疾病
生津	疾病
味蕾	疾病
花椒膏药病	疾病
谷草转氨酶	疾病
热带假丝酵母	疾病
高铁血红蛋白症	疾病
肠原性青紫病	疾病
高铁血红蛋白血症	疾病
惊厥	疾病
烟瘾	疾病
清热	疾病
脾胃	疾病
人妖	疾病
蕈类	疾病
豆腐浆	疾病
血管紧张素转化酶	疾病
霜霉病	疾病
翻胃	疾病
疫病	疾病
直肠脱垂	疾病
艾滋病	病毒
营养物	疾病
胃虚	疾病
外耳道异物	疾病
心痛	疾病
补肾	疾病
阳虚	疾病
合成类固醇	疾病
胆固醇结石	疾病
总胆固醇偏高	疾病
异黄酮	疾病
呼吸系统	疾病
胆石症	疾病
皮质激素	疾病
低密度胆固醇	疾病
肠粘膜脱落	疾病
低密度脂蛋白脂固醇	疾病
胆汁淤积	疾病
雄性激素	疾病
胆固醇高	疾病
胆囊	疾病
传染	病毒
传染	疾病
血清总胆固醇	疾病
醛固酮	疾病
肺损伤	疾病
维生素K缺乏症	疾病
血小板减少性紫癜	疾病
病原携带者	疾病
脓肿	疾病
骨瘤	疾病
慢性骨髓炎	疾病
慢性血源性骨髓炎	疾病
急性血源性骨髓炎	疾病
掌跖脓疱病	疾病
传染期	疾病
视网膜病变	疾病
后葡萄膜炎	疾病
玻璃体积血	疾病
瘀斑	疾病
难产	疾病
过期妊娠	疾病
乙类传染病	疾病
脑肿瘤	疾病
狭颅症	疾病
萎缩斑	疾病
甲营养不良	疾病
急性甲沟炎	疾病
结节	疾病
传染过程	疾病
寄生虫感染	疾病
红斑	疾病
玫瑰疹	疾病
脊髓痨	疾病
阴阜	疾病
包皮	疾病
粘膜白斑	疾病
获得性梅毒	疾病
结节性梅毒疹	疾病
排便困难	疾病
西班牙流行性感冒	疾病
脐带血	疾病
斑丘疹	疾病
寻常性痤疮	疾病
巩膜炎	疾病
前房积血	疾病
近视	疾病
尿道狭窄	疾病
紧张性头痛	疾病
腹主动脉瘤	疾病
周围动脉瘤	疾病
中暑	疾病
脑栓塞	疾病
物理治疗	疾病
丛集性头痛	疾病
脑血管畸形	疾病
颅内血肿	疾病
蛔虫病	疾病
疣状表皮发育不良	疾病
癔症	疾病
药物依赖	疾病
疣状皮肤结核	疾病
肾移植	疾病
化脓性脑炎	疾病
斑疹伤寒	疾病
传染病	疾病
脓疱病	疾病
巨细胞动脉炎	疾病
脑损伤	疾病
结节性多动脉炎	疾病
史蒂文斯-约翰逊综合征	疾病
多胎妊娠	疾病
钩虫病	疾病
眼球突出	疾病
常年性鼻炎	疾病
药物性鼻炎	疾病
急性鼻窦炎	疾病
肝母细胞瘤	疾病
豆腐渣样白带	疾病
性传染疾病	疾病
白斑	疾病
甲沟炎	细菌
甲沟炎	疾病
油漆皮炎	疾病
养胃	疾病
皮角	疾病
火疖子	疾病
黄曲霉毒素中毒	疾病
黏多糖	疾病
血清淀粉酶	疾病
消化道传染病	疾病
重症急性胰腺炎	疾病
胰腺损伤	疾病
胰腺假性囊肿	疾病
肝出血	疾病
关节	疾病
胀气	疾病
新生儿破伤风	疾病
肠扭转	疾病
滑肠	疾病
强化免疫	疾病
肠梗塞	疾病
肠出血	疾病
流行性脑脊髓膜炎	疾病
脘腹胀满	疾病
惊痫	疾病
因子对	疾病
齿根	疾病
磨牙	疾病
血糖生成指数	疾病
甘蔗汁	疾病
螨虫	疾病
泌尿系结石	疾病
胃痛	疾病
遗尿症	疾病
防癌	疾病
神经肌肉接头	疾病
头孢匹罗	疾病
莫西林	疾病
长高	疾病
脉搏	疾病
霉变	疾病
血吸虫	疾病
维生素R	疾病
硬化症	疾病
烟碱酸	疾病
流耳	疾病
黑皮病	疾病
高处坠落事故	疾病
恋尸癖	疾病
奸尸	疾病
经期	疾病
疼痛	疾病
补气	疾病
神经痛	疾病
检疫传染病	疾病
机械通气	疾病
生殖器	疾病
血吸虫卵	疾病
前驱期	疾病
猪流行性感冒	疾病
视力障碍	疾病
机械性损伤	疾病
突发公共卫生事件	疾病
慢性肝炎	疾病
接种	疾病
血液传染病	疾病
重型肝炎	疾病
性病淋巴肉芽肿	疾病
姜片虫病	疾病
副霍乱	疾病
绦虫病	疾病
体表传染病	疾病
实验流行病学	疾病
病因推断	疾病
疾病流行强度	疾病
化脓性感染	疾病
地方性氟中毒	疾病
疾病分布	疾病
环境病	疾病
疾病自然史	疾病
占位病变	疾病
儿科	疾病
脑脊髓膜炎	疾病
鞘内注射	疾病
乳突炎	疾病
颅压增高	疾病
脑膜刺激征	疾病
硬膜下积液	疾病
新生儿期	疾病
嗜睡	疾病
呼吸道传染病	疾病
妊娠合并淋病	疾病
臀先露	疾病
胎膜早破	疾病
附件炎	疾病
慢性血吸虫病	疾病
盆腔脓肿	疾病
股外侧皮神经炎	疾病
麻疹疫苗	疾病
周围神经损伤	疾病
蕈样肉芽肿	疾病
神经纤维瘤	疾病
血吸虫性肝硬化	疾病
眼睑闭合不全	疾病
鼻中隔穿孔	疾病
瘟疫	疾病
前庭大腺	疾病
尿道旁腺	疾病
阴毛	疾病
男性生殖系统	疾病
生理期	疾病
飞沫传播	疾病
传染源	疾病
门静脉高压症	疾病
肝纤维化	疾病
酒精性肝炎	疾病
生命体征	疾病
西尼罗河热	疾病
发高烧	疾病
脑膜脑炎	疾病
氧疗	疾病
传染病流行	疾病
西尼罗热	疾病
过敏性皮疹	疾病
吸氧	疾病
麻疹强化免疫	疾病
免疫规划	疾病
活动性结核	疾病
支气管肺炎	疾病
血液病	疾病
第三次鼠疫大流行	疾病
噩梦	疾病
蟠尾丝虫症	疾病
疠气	疾病
安东尼瘟疫	疾病
辨证论治	疾病
吴有性	疾病
自然疫原性疾病	疾病
医学观察	疾病
短期波动	疾病
感染症	疾病
疫源地	疾病
皮下结节	疾病
恐水症	疾病
流行过程	疾病
呼吸麻痹	疾病
稽留热	疾病
计划免疫	疾病
五软	疾病
血行播散型肺结核	疾病
支原体	疾病
电光性眼炎	疾病
精液	疾病
纵隔肿瘤	疾病
急性蜂窝织炎	疾病
活疫苗	疾病
接触传播	疾病
水平传播	病毒
水平传播	疾病
痧子	疾病
人群易感性	疾病
包虫病	疾病
系统回顾	疾病
人畜共患病	疾病
面部痉挛	疾病
鹅膏毒素	疾病
复视	疾病
萝卜腿	疾病
眼睑痉挛	疾病
控制传染源	疾病
皮肤科	疾病
慢病	疾病
医疗效果	疾病
学校卫生	疾病
隔离期	疾病
红肿	疾病
预防接种异常反应	疾病
流脑疫苗	疾病
分离性障碍	疾病
疫点	疾病
肺炎疫苗	疾病
洗澡	疾病
额外心音	疾病
出院记录	疾病
诊断	疾病
压痛	疾病
枪击音	疾病
运动障碍	疾病
脓包	疾病
液波震颤	疾病
生理反射	疾病
嗳气	疾病
行经期	疾病
角膜反射	疾病
鼓音	疾病
心包摩擦音	疾病
牙龈出血	疾病
交替脉	疾病
手足口病	病毒
肝颈静脉回流征	疾病
腹部包块	疾病
叩诊音	疾病
问诊	疾病
唾液分泌	疾病
体格检查	疾病
食欲异常	疾病
桡动脉	疾病
心包摩擦感	疾病
肠鸣音	疾病
肺炭疽	疾病
病程记录	疾病
前囟门	疾病
护理	疾病
颈静脉怒张	疾病
反酸	疾病
阴性症状	疾病
死产	疾病
辅助检查	疾病
喘鸣	疾病
心尖搏动	疾病
水冲脉	疾病
异常呼吸	疾病
特殊检查	疾病
杵状指	疾病
脉书	疾病
舌苔	疾病
尿急	疾病
呼吸频率	疾病
气促	疾病
丙类传染病	疾病
肛门指检	疾病
提睾反射	疾病
奔马律	疾病
胸膜摩擦音	疾病
心音	疾病
乳房检查	疾病
内痔	疾病
生殖系统疾病	疾病
现病史	疾病
传播途径	疾病
病理反射	疾病
典型肺炎	疾病
流行感冒	疾病
排尿困难	疾病
肾功能检查	疾病
克拉霉素	疾病
流鼻涕	疾病
疤痕	疾病
鼻硬结	疾病
溶组织内阿米巴病	疾病
特殊染色	疾病
非洲锥虫病	疾病
肠粘连	疾病
肛管癌	疾病
肠结核	疾病
皮肤结核	疾病
肠穿孔	疾病
寄生虫	疾病
寄生虫	疾病
腮腺	疾病
牙齿松动	疾病
既往史	疾病
十二指肠降部	疾病
胃泌素	疾病
空肠	疾病
牙齿腐蚀	疾病
烧心	疾病
结肠	疾病
十二指肠悬韧带	疾病
憩室	疾病
食管	疾病
卫生防疫	疾病
医疗过失	疾病
感冒发烧	疾病
增强免疫力	疾病
筋骨疼痛	疾病
利尿	疾病
呼吸道疾病	疾病
脑供血不足	疾病
儿童补锌	疾病
喉咙	疾病
腰腿痛	疾病
医疗质量	疾病
补铁	疾病
缺锌	疾病
冬季心理流感	疾病
春困	疾病
秋乏	疾病
反复呼吸道感染	疾病
致敏	疾病
养肾	疾病
病症	疾病
主细胞	疾病
器质性	疾病
胃蛋白酶测定	疾病
视力模糊	疾病
烟碱样症状	疾病
生理氯化钠溶液	疾病
毒蕈碱	疾病
代偿功能	疾病
胆碱能神经元	疾病
阿托品化	疾病
有机磷酸酯	疾病
肌肉损伤	疾病
枯草热	疾病
哮喘性支气管炎	疾病
过敏性皮肤病	疾病
人工型荨麻疹	疾病
嘌呤代谢	疾病
传染病	疾病
肾单位	疾病
肾衰	疾病
人脑髓鞘碱性蛋白	疾病
抗环瓜氨酸肽抗体	疾病
吸入	疾病
下血	疾病
原发性开角型青光眼	疾病
过敏性哮喘	疾病
预防接种	疾病
出血	疾病
眼外伤	疾病
糖尿病昏迷	疾病
远视	疾病
出汗	疾病
幼儿	疾病
手纹	疾病
高脂蛋白血症	疾病
脂肪浸润	疾病
喜阳植物	疾病
病历	疾病
黑色素沉着	疾病
痹痛	疾病
自汗	疾病
右心室	疾病
枕骨大孔	疾病
退化变性	疾病
睾丸间质细胞	疾病
甲类传染病	疾病
附睾管	疾病
老年斑	疾病
神经退行性疾病	疾病
囊肿性纤维化	疾病
基因分型	疾病
个人基因图谱	疾病
多基因遗传病	疾病
镰形细胞贫血	疾病
褐色脂肪组织	疾病
弱视	疾病
白细胞	疾病
下呼吸道感染	疾病
急性淋巴结炎	疾病
泡性结膜炎	疾病
角化棘皮瘤	疾病
眼白	疾病
感染性结膜炎	疾病
急性青光眼	疾病
虹膜炎	疾病
鸽乳	疾病
动脉粥样硬化症	疾病
阿米巴肠病	疾病
慢性泪囊炎	疾病
急性泪囊炎	疾病
分子病	疾病
手机辐射	疾病
直肠肿瘤	疾病
T细胞淋巴瘤	疾病
拉米夫定	疾病
超量恢复	疾病
黑热病	疾病
着色性干皮病	疾病
不良生活习惯	疾病
慢性鼻窦炎	疾病
鼻甲肥大	疾病
头昏	疾病
黑豚鼠	疾病
消化系统	疾病
总蛋白	疾病
凝血功能	疾病
增殖细胞	疾病
前白蛋白	疾病
碱中毒	疾病
性传播	疾病
筛检	疾病
食源性疾病	疾病
生命质量	疾病
促甲状腺激素	疾病
出血倾向	疾病
爆发性肝炎	疾病
肝功能障碍	疾病
内毒素休克	疾病
多器官功能衰竭	疾病
内毒素血症	疾病
糖代谢紊乱	疾病
激素类药物	疾病
水稻黄矮病	疾病
胃蛋白酶	疾病
低渗溶液	疾病
皮肤发黄	疾病
神经元细胞	疾病
淋巴因子激活杀伤细胞	疾病
促生长因子	疾病
胚胎癌	疾病
女性疾病	疾病
创伤	疾病
老年性紫癜	疾病
抵抗力	疾病
脱氢异雄酮	疾病
骨坏死	疾病
避孕	疾病
违禁药物	疾病
蛋白同化激素	疾病
退行性骨关节病	疾病
黄体酮	疾病
喉头炎	疾病
农药中毒	疾病
胆碱酯酶	疾病
霉心病	疾病
黄胆	疾病
退热	疾病
脚踝	疾病
健康管理	疾病
化痰	疾病
黄斑病	疾病
坏血病	疾病
自然灾难	疾病
水肿	疾病
赤痢	疾病
疥癣	细菌
疥癣	疾病
风热	疾病
壮阳	疾病
精血	疾病
冰糖柑	疾病
降火	疾病
环境流行病学	疾病
计划生育	疾病
肾上腺素	疾病
阴虚火旺	疾病
躁狂症	疾病
虚劳	疾病
阳痿	疾病
滑精	疾病
现代实用中药	疾病
深度睡眠	疾病
上班族	疾病
牛黄上清丸	疾病
痰迷	疾病
生长激素	疾病
血糖	疾病
三十六黄	疾病
线虫病	疾病
就巢性	疾病
缺血性心脏病	疾病
虚寒	疾病
医疗	疾病
粘液便	疾病
旅游者腹泻	疾病
粘液血便	疾病
胰岛素	疾病
ATG	疾病
质壁分离复原	疾病
牙龈炎	疾病
牛泰勒焦虫病	疾病
胃火	疾病
兽医学	疾病
鼠蚤	疾病
败血型鼠疫	疾病
腺鼠疫	疾病
大叶肺炎	疾病
药物过敏反应	疾病
内热	疾病
败血症鼠疫	疾病
冬季	疾病
外科感染	疾病
透析	疾病
脲原体属	疾病
基因检测	疾病
慢性间质性肾炎	疾病
肾脓肿	疾病
蚕豆病	疾病
皮炎	疾病
输尿管	疾病
槭糖尿病	疾病
伤口	疾病
巨幼红细胞性贫血	疾病
泌尿系统结石	疾病
视神经萎缩	疾病
皮下出血	疾病
内耳眩晕症	疾病
骨关节	疾病
舔食者	疾病
神经根	疾病
病灶	疾病
脊柱炎	疾病
哨卫淋巴结	疾病
光老化	疾病
早老症	疾病
玻璃体	疾病
脑寄生虫病	疾病
脑脊液漏	疾病
脑膜白血病	疾病
中枢神经系统感染	疾病
流行性脑炎	疾病
脉络丛	疾病
第四脑室	疾病
发物	疾病
颅内压降低	疾病
动脉硬化症	疾病
脑血管病	疾病
肠伤寒	疾病
血脂代谢紊乱	疾病
脑胶质瘤	疾病
硬膜下血肿	疾病
脱髓鞘病	疾病
胶质瘤	疾病
舞蹈症	疾病
侧脑室	疾病
睑内翻	疾病
脊髓蛛网膜炎	疾病
胡萝卜素血症	疾病
视神经炎	疾病
急性脑梗塞	疾病
脊髓压迫症	疾病
继发性癫痫	疾病
左旋咪唑	疾病
猪霍乱	疾病
牙龈退缩	疾病
碘缺乏	疾病
心脏扩大	疾病
心电图异常	疾病
血栓	疾病
缺铁	疾病
铁缺乏症	疾病
肠热症	疾病
富马酸亚铁	疾病
眼结膜	疾病
妊娠高血压	疾病
铁中毒	疾病
中毒性休克	疾病
肝脾肿大	疾病
光变态反应	疾病
传染性红斑	病毒
传染性红斑	疾病
疹	疾病
鸡胸	疾病
膝内翻	疾病
肺梗塞	疾病
趋化性细胞因子	疾病
倒睫	疾病
骨量	疾病
X形腿	疾病
原发性骨质疏松症	疾病
放射性损伤	疾病
神经修复	疾病
血钙	疾病
骨密度	疾病
骨盆	疾病
离子钙	疾病
母乳喂养	疾病
肚脐	疾病
缺损	疾病
机体防御	疾病
肺炎衣原体	细菌
肺炎衣原体	疾病
增生	疾病
沙眼衣原体	疾病
鹦鹉热嗜衣原体	病毒
鹦鹉热嗜衣原体	疾病
低镁血症	疾病
子宫复旧	疾病
奶反射	疾病
鸽痘	病毒
鸽痘	疾病
抗凝血	疾病
乳头皲裂	疾病
足月儿	疾病
吐奶	疾病
溢奶	疾病
卵巢癌	疾病
青春期肥胖症	疾病
急性乳腺炎	疾病
开奶	疾病
呛奶	疾病
母乳不足	疾病
缺钾症	疾病
心率不齐	疾病
室性早搏	疾病
小腿溃疡	疾病
镰刀型红血球疾病	疾病
凝血酶原时间	疾病
口炎性腹泻	疾病
新生儿溶血性贫血	疾病
禽痘	疾病
经证	疾病
狼疮细胞	疾病
运动性失语	疾病
偏盲	疾病
神经内科	疾病
单瘫	疾病
短暂性脑缺血发作	疾病
假性延髓麻痹	疾病
脑卒中	疾病
血凝素	疾病
肠外阿米巴病	疾病
免疫复合物病	疾病
狼疮性脂膜炎	疾病
血管痉挛	疾病
皮肤色素沉着	疾病
皮肤萎缩	疾病
血小板功能异常	疾病
光过敏	疾病
雷诺现象	疾病
遗传性出血性毛细血管扩张症	疾病
原发性血小板减少性紫癜	疾病
皮肤利什曼病	疾病
血窦	疾病
阿米巴肝脓肿	疾病
溶血反应	疾病
血吸虫尾蚴性皮炎	疾病
季节性鼻炎	疾病
特应性皮炎	疾病
食物过敏	疾病
乳房炎	疾病
膀胱结石	疾病
过敏症	疾病
输尿管结石	疾病
甲状旁腺功能亢进	疾病
尿道结石	疾病
肾下垂	疾病
砷中毒	疾病
出血性疾病	疾病
肾积水	疾病
医院感染	疾病
睾丸鞘膜	疾病
药物不良反应	疾病
间皮	疾病
大便失禁	疾病
免疫缺损	疾病
肝包虫病	疾病
腹膜后肿瘤	疾病
鼻涕	疾病
继发性红细胞增多症	疾病
流式细胞技术	疾病
平均血小板体积	疾病
平均红细胞体积	疾病
平均血红蛋白浓度	疾病
乳腺	疾病
嗜酸性粒细胞计数	疾病
红细胞体积分布宽度	疾病
红细胞系	疾病
异型淋巴细胞	疾病
纤维蛋白溶解	疾病
血小板计数	疾病
血细胞分析	疾病
胃气上逆	疾病
胃肠道癌	疾病
营养性贫血	疾病
肾上腺皮质激素	疾病
松果腺	疾病
高胰岛素血症	疾病
动态突变	疾病
星状胶质细胞	疾病
氮麻醉	疾病
NTS	疾病
白痴	疾病
组织化生	疾病
男性尿道	疾病
类固醇激素	疾病
汗腺	疾病
肌病	疾病
房室传导阻滞	疾病
室性心动过速	疾病
性腺	疾病
尿液	疾病
颈椎	疾病
疗养院	疾病
工业中毒	疾病
曲霉病	疾病
蛇咬伤	疾病
减压病	疾病
检验科	疾病
艾滋病检测	疾病
脑脊液	疾病
鸡尾酒疗法	疾病
抑制神经	疾病
全基因组关联研究	疾病
线粒体病	疾病
五味子素	疾病
心气虚	疾病
心肾不交	疾病
巴黎学派	疾病
结核性溃疡	疾病
创伤性溃疡	疾病
肾盂肾炎	疾病
营养不良性肝硬化	疾病
乳糖不耐受	疾病
膳食结构	疾病
口唇青紫	疾病
心脏传导系统	疾病
降钙素	疾病
胃酸过多	疾病
外源性感染	疾病
慢性脑膜炎	疾病
膝外翻	疾病
脂蛋白	疾病
骨关节病	疾病
利福霉素类抗生素	疾病
中毒病	疾病
蝇蛆病	疾病
生理无效腔	疾病
支气管镜检查	疾病
肺通气	疾病
猪肺疫	疾病
眼睑炎	疾病
猪传染性胸膜肺炎	疾病
红斑毒素	疾病
听力测定	疾病
药物热	疾病
肌酐	疾病
溃疡病穿孔	疾病
嗜酸粒细胞增多症	疾病
血浆蛋白结合率	疾病
血肌酐	疾病
气喘	疾病
超氧化歧化酶	疾病
鼠疫	疾病
酒石酸锑钾	疾病
水钠潴留	疾病
亚麻油酸	疾病
吸收不良综合症	疾病
巨幼红细胞	疾病
血液学	疾病
消耗性疾病	疾病
神经学	疾病
心身症	疾病
侵染	疾病
艾德温·史密斯纸草文稿	疾病
小儿科	疾病
免疫缺陷综合症	疾病
持续感染	疾病
痄腮	疾病
老年性白内障	疾病
黏膜白斑	疾病
口底癌	疾病
腭癌	疾病
神经生长因子	疾病
母乳	疾病
涎腺癌	疾病
上颌窦癌	疾病
唇癌	疾病
口腔黏膜白斑	疾病
颌骨癌	疾病
磷酸葡萄糖变位酶	疾病
糖原累积病	疾病
AZT	疾病
无尿	疾病
泌尿系统疾病	病毒
泌尿系统疾病	疾病
人尿	疾病
尿色	疾病
尿颜色	疾病
运动性血尿	疾病
尿道炎症	疾病
挤压伤	疾病
喉部肿瘤	疾病
食道狭窄	疾病
下咽癌	疾病
下颌骨	疾病
丹毒	疾病
淋巴结转移	疾病
口咽癌	疾病
声带癌	疾病
颌下腺	疾病
心电监护	疾病
钡中毒	疾病
晚疫病	疾病
展神经	疾病
败血症性休克	疾病
心肌收缩力	疾病
心主血	疾病
五脏六腑	疾病
气血不通	疾病
温热病	疾病
肝火犯肺	疾病
迷走神经	疾病
气分	疾病
胃气不降	疾病
维生素K	疾病
面神经	疾病
小便短赤	疾病
副神经	疾病
动眼神经	疾病
端坐呼吸	疾病
颅底	疾病
六邪	疾病
视神经	疾病
肾阳不足	疾病
羊水	疾病
心肾相交	疾病
燥湿化痰	疾病
滑车神经	疾病
气短	疾病
四诊	疾病
脾阳虚	疾病
憋尿	疾病
甲状旁腺激素	疾病
血栓性脉管炎	疾病
咳喘	疾病
脑动脉炎	疾病
身重	疾病
前庭蜗神经	疾病
八纲辨证	疾病
小便频数	疾病
肝血不足	疾病
静脉瓣	疾病
少尿	疾病
肾精亏虚	疾病
嗅神经	疾病
挥发酸	疾病
肌肉痉挛	疾病
仔猪黄白痢	疾病
僵猪	疾病
继发效应	疾病
止痛	疾病
中药热敷	疾病
隔蒜灸	疾病
放射治疗	疾病
体温监测	疾病
热疗法	疾病
狐惑病	疾病
变态反应	疾病
超短波疗法	疾病
闭塞性动脉硬化症	疾病
血管性偏头痛	疾病
药物中毒	疾病
崩	疾病
代谢性疾病	疾病
脑电波	疾病
昏迷	疾病
对光反射	疾病
高尿酸	疾病
皮肤黏膜	疾病
加兰他敏	疾病
双胞胎	疾病
凉血	疾病
痘病	疾病
橘皮组织	疾病
疲劳	疾病
胆道感染	疾病
泌乳	疾病
毛细血管壁	疾病
ACTH	疾病
急救	疾病
安神	疾病
药物性肝硬化	疾病
心源性肝硬化	疾病
夜盲症	疾病
痛风石	疾病
胸闷	疾病
正体类要	疾病
虚症	疾病
应激性溃疡	疾病
反胃	疾病
慢性便秘	疾病
急性肾炎	疾病
慢性肾炎	疾病
直接胆红素	疾病
肾小管	疾病
潴留	疾病
心源性猝死	疾病
性关系	疾病
髓外造血	疾病
中性粒细胞增多症	疾病
血小板疾病	疾病
传染性淋巴细胞增多症	疾病
增生性贫血	疾病
血液病学	疾病
肌力	疾病
淋巴结	疾病
低嘌呤	疾病
酸溶血试验	疾病
骨髓增生性疾病	疾病
活检	疾病
尿潜血	疾病
粒细胞减少症	疾病
嗜酸性粒细胞增多症	疾病
抗人球蛋白试验	疾病
病原学	疾病
骨髓检查	疾病
胸骨压痛	疾病
磷酸葡萄糖异构酶	疾病
胃痉挛	疾病
红细胞计数	疾病
阵发性睡眠性血红蛋白尿症	疾病
肾性贫血	疾病
血小板无力症	疾病
四氯汞钠	疾病
紧身胸衣	疾病
血清钙	疾病
接骨	疾病
营养缺乏症	疾病
第三磨牙	疾病
心理疾病	疾病
内分泌疾病	疾病
青少年发育	疾病
胡须	疾病
儿童期	疾病
职业性白内障	疾病
肠衣	疾病
酒精过敏	疾病
肝功	疾病
肥达反应	疾病
雪水	疾病
抗胰蛋白酶	疾病
截肢	疾病
心脏移植	疾病
发炎	疾病
精神萎靡	疾病
重大疾病	疾病
亚急性重型肝炎	疾病
血清球蛋白	疾病
乙肝患者	疾病
慢性肝病	疾病
小儿肺泡性蛋白沉积症	疾病
人胎盘	疾病
皮肤荨麻疹	疾病
白球比	疾病
肝功能检查	疾病
白发	疾病
苯丙胺精神病	疾病
中毒性精神障碍	疾病
有毒物质	疾病
烧焊	疾病
继发性高甘油三酯血症	疾病
人型支原体	疾病
接触性出血	疾病
急性尿道炎	疾病
白带异常	疾病
脓毒症	疾病
生殖支原体	疾病
下腹痛	疾病
新生儿眼炎	疾病
鼻疽	疾病
猪丹毒	疾病
链霉素	疾病
霉变甘蔗中毒	疾病
囊虫病	疾病
猪水泡病	疾病
骨疣	疾病
多基因病	疾病
人胰岛素	疾病
现患率	疾病
慢性扁桃腺炎	疾病
杨梅舌	疾病
超声心动图	疾病
诱因	疾病
急性发热	疾病
尿频尿急	疾病
彩超	疾病
心脏杂音	疾病
前列环素	疾病
补液量	疾病
头皮损伤	疾病
弛张热	疾病
辐射损伤	疾病
血容量	疾病
克山病	疾病
脂漏性皮肤炎	疾病
学步车	疾病
吸吮反射	疾病
厌奶	疾病
母乳性黄疸	疾病
病理性黄疸	疾病
厌奶期	疾病
异位性皮肤炎	疾病
甲状腺肿	疾病
维生素b1	疾病
有孔毛细血管	疾病
灰白质	疾病
风热乳蛾	疾病
虚火上炎	疾病
咽淋巴环	疾病
儿童保健	疾病
自闭症	疾病
神经束	疾病
扁桃体周围脓肿	疾病
呛咳	疾病
化脓	疾病
乳蛾	疾病
血管运动神经	疾病
轴突反射	疾病
舒张神经	疾病
肝静脉	疾病
心血管反射	疾病
交感神经兴奋	疾病
左心房	疾病
减压反射	疾病
脑循环	疾病
痛痛病	疾病
有毒污染物	疾病
狼疮抗凝物	疾病
血清铁蛋白	疾病
气虚血瘀	疾病
气滞血瘀型	疾病
方颅	疾病
肢体麻木	疾病
肝气郁结	疾病
低体重儿	疾病
活血化瘀	疾病
孕早期	疾病
血液稀释	疾病
畸形儿	疾病
缺钙	疾病
轻度贫血	疾病
胎儿宫内发育迟缓	疾病
血同型半胱氨酸	疾病
腰酸	疾病
伤寒	疾病
视觉欺骗	疾病
夜盲症	疾病
神经通路	疾病
脉络膜	疾病
视觉中枢	疾病
神经脉冲	疾病
听觉中枢	疾病
乳脂肪	疾病
蚕病	疾病
皮肤老化	疾病
心前区疼痛	疾病
毛发异常	疾病
肾性尿崩症	疾病
血清钾	疾病
高渗性脱水	疾病
轻度脱水	疾病
失语症	疾病
病理	疾病
小肠梗阻	疾病
脱水热	疾病
中枢性尿崩症	疾病
体位性低血压	疾病
尿比重	疾病
低渗性脱水	疾病
尿量	疾病
小肠瘘	疾病
渗透性利尿	疾病
脉细数	疾病
中度脱水	疾病
失水	疾病
等渗性脱水	疾病
面部潮红	疾病
多尿	疾病
有效循环血量	疾病
颅内出血	疾病
病理状态	疾病
血清钠	疾病
维生素B12	疾病
慢性化脓性中耳炎	疾病
耶尔森	疾病
肝坏死	疾病
口鼻出血	疾病
肌肉酸痛	疾病
绿猴病	疾病
马尔堡出血热	病毒
马尔堡出血热	疾病
外科精义	疾病
实验诊断	疾病
Rh阳性血型	疾病
病源	疾病
Rh血型系统	疾病
气虚质	疾病
积滞	疾病
七气	疾病
低血容量性休克	疾病
传染性鼻炎	疾病
胸膜肺炎	疾病
小儿支原体肺炎	疾病
牛羊腐蹄病	疾病
坏疽性皮炎	疾病
纵膈淋巴结肿大	疾病
猪痢疾	疾病
鸡传染性鼻炎	疾病
坏死性肠炎	疾病
鸡毒支原体感染	疾病
鸡传染性支气管炎	疾病
化脓性心包炎	疾病
鸡慢性呼吸道病	疾病
鸡传染性喉气管炎	疾病
肺小叶	疾病
不饱和脂肪酸	疾病
禽霍乱	疾病
马腺疫	疾病
羊传染性胸膜肺炎	疾病
中央辅音	疾病
牙周疾病	疾病
药物性牙龈增生	疾病
食物嵌塞	疾病
牙齿保健	疾病
牙周组织	疾病
尿	疾病
牙龈病	疾病
慢性龈缘炎	疾病
牙龈瘤	疾病
新生儿斑痣	疾病
真皮层	疾病
血管痣	疾病
肺动静脉瘘	疾病
冷冻治疗	疾病
疮毒	疾病
咽喉癌	疾病
胃阴亏虚	疾病
儿童多动症	疾病
赤目	疾病
健脾	疾病
肥厚性心肌病	疾病
体质性低血压	疾病
主动脉瓣狭窄	疾病
鸡球虫病	疾病
兔球虫病	疾病
烟酸	疾病
血管通路	疾病
冠状静脉	疾病
血管阻力	疾病
心肌肥厚	疾病
舒张压	疾病
动脉血管	疾病
冠状动脉搭桥手术	疾病
冠脉循环	疾病
冠脉血流量	疾病
死亡	疾病
植物黄油	疾病
右心房	疾病
血液量	疾病
上颌动脉	疾病
静脉角	疾病
射血期	疾病
球虫病	疾病
肝脏肿瘤	疾病
急性中毒	疾病
增殖细胞核抗原	疾病
甲苯中毒	疾病
中毒性视神经病变	疾病
髋关节结核	疾病
慢性喉炎	疾病
啤酒心	疾病
啤酒肚	疾病
中毒性肝病	疾病
戒酒	疾病
衣原体	疾病
5'-核苷酸酶	疾病
痘苗	细菌
痘苗	疾病
双硫仑	疾病
戈谢病	疾病
尼曼-匹克病	疾病
真性红细胞增多症	疾病
立克次体感染	疾病
异基因骨髓移植	疾病
几丁聚糖	疾病
中老年	疾病
结痂	疾病
肢端溶骨症	疾病
造血系统	疾病
肾上腺皮质激素类药物	疾病
身高	疾病
先天性巨结肠	疾病
痉挛性便秘	疾病
腰骶部	疾病
直肠息肉	疾病
胃十二指肠溃疡大出血	疾病
发育	疾病
硫血红蛋白血症	疾病
脓血便	疾病
肠源性紫绀	疾病
大便下血	疾病
胃结肠反射	疾病
肛门狭窄	疾病
心跳心慌	疾病
肝掌	疾病
多梦	疾病
发热	疾病
上热下寒	疾病
手诊	疾病
医院获得性肺炎	疾病
粘膜病	疾病
血粘稠	疾病
阴阳失调	疾病
失眠多梦	疾病
妊娠期	疾病
趾甲	疾病
诊断学	疾病
蛋类	疾病
补牙	疾病
口腔疾病	疾病
内科学	疾病
牙本质过敏	疾病
早衰	疾病
老年病	疾病
镶牙	疾病
脑白质	疾病
釉质	疾病
颈项强直	疾病
舌系带过短	疾病
六龄牙	疾病
卫生事业管理专业	疾病
病灶感染	疾病
牙磨损	疾病
粘膜皱襞	疾病
系统性红斑狼疮	疾病
缺牙	疾病
牙体牙髓病	疾病
牙体缺损	疾病
滞颐	疾病
脑炎后遗症	疾病
小儿流涎	疾病
延髓麻痹	疾病
发情期	疾病
虚火牙痛	疾病
脱矿	疾病
疫苗接种	疾病
新生儿体重	疾病
牙列不齐	疾病
儿童强迫症	疾病
脑瘫	疾病
淋巴引流	疾病
髓海	疾病
猪肺炎	疾病
脾胃虚寒证	疾病
舌系带	疾病
球蛋白	疾病
上颌	疾病
胃火牙痛	疾病
赶上生长	疾病
牙齿疼痛	疾病
血管疾病	疾病
肠	疾病
下寿	疾病
消谷善饥	疾病
遗传疾病	疾病
消谷	疾病
色夭	疾病
性能力	疾病
脑烁	疾病
神经降压素	疾病
瘅热	疾病
金钱蛭	疾病
胃肠激素	疾病
生长抑素	疾病
晨练	疾病
足跟痛	疾病
B族维生素	疾病
肺部疾病	疾病
公害病	疾病
镉中毒	疾病
胃胀	疾病
冰箱病	疾病
胃破裂	疾病
安哥拉兔	疾病
地中海式饮食	疾病
恶心	疾病
胆总管	疾病
皮肤粘膜淋巴结	疾病
维生素H	疾病
肌萎缩侧索硬化	疾病
构象病	疾病
血性痰	疾病
主动脉瘤	疾病
灼伤	疾病
强酸中毒	疾病
视觉障碍	疾病
发烧	疾病
发烧	疾病
发烧	疾病
隐性感染	疾病
用脑过度	疾病
脑力劳动	疾病
头皮癣	疾病
唾液检测	疾病
滋补品	疾病
肾水	疾病
晕厥	疾病
心肌损伤	疾病
MRI	疾病
仿雌激素	疾病
毛细血管	疾病
骨痛病	疾病
急性心肌炎	疾病
阴暑	疾病
绿豆粥	疾病
阳暑	疾病
骨骺	疾病
肋软骨	疾病
察布查尔病	疾病
藏红花素	疾病
食品卫生	疾病
血球凝集素	疾病
情感迟钝	疾病
癫痫性精神障碍	疾病
情感性精神病	疾病
精神障碍	疾病
慢性感染	病毒
慢性感染	疾病
急性肠炎	疾病
炎症性肠病	疾病
感染率	疾病
AMI	疾病
营养因子	疾病
B细胞淋巴瘤	疾病
瘙痒	疾病
滋阴	疾病
疾病遗传	疾病
鳞状上皮细胞	疾病
扁桃腺	疾病
胸透	疾病
神经干细胞	疾病
厌食症	疾病
骨	疾病
肋膈角	疾病
胫腓骨骨干骨折	疾病
面部神经	疾病
骨盆骨折	疾病
皮肤粘膜	疾病
股骨骨折	疾病
脊柱骨折	疾病
辐射危害	疾病
骨髓癌	疾病
丙硫氧嘧啶	疾病
卵巢功能低下	疾病
甲状旁腺疾病	疾病
促卵泡素	疾病
乳腺疾病	疾病
婴幼儿	疾病
亚急性甲状腺炎	疾病
甲状旁腺功能减退症	疾病
内分泌科	疾病
面部色斑	疾病
乳腺检查	疾病
围绝经期	疾病
溢乳症	疾病
声带麻痹	疾病
黄体素	疾病
黄体脂酮素	疾病
原发性醛固酮增多症	疾病
月经量	疾病
卵泡期	疾病
绝经期	疾病
气血两虚	疾病
甲状旁腺功能亢进症	疾病
临床	疾病
核苷酸	疾病
瘫痪	疾病
放射损伤	疾病
浸润癌	疾病
贲门癌	疾病
淋巴道转移	疾病
素食主义	疾病
铁粒幼细胞性贫血	疾病
十二指肠上部	疾病
种植性转移	疾病
血道转移	疾病
17-羟皮质类固醇	疾病
放射性核素检查	疾病
言语障碍	疾病
金属烟热	疾病
继发性糖尿病	疾病
足	疾病
肠胀气	疾病
胆道结石	疾病
促肾上腺皮质激素	疾病
宣泄	疾病
超声波检查	疾病
腰背痛	疾病
胰岛	疾病
胆源性胰腺炎	疾病
胰腺脓肿	疾病
季肋部	疾病
超声成像	疾病
疏肝理气	疾病
促黄体生成素	疾病
色氨酸羟化酶	疾病
蓝斑	疾病
运动神经元	疾病
胀肚	疾病
器质性病变	疾病
男性	疾病
麦胶性肠病	疾病
阳气不足	疾病
嗳腐	疾病
营养元素	疾病
吞酸	疾病
舌苔厚	疾病
中脑黑质	疾病
神经肽Y	疾病
脑干网状结构	疾病
器质性疾病	疾病
胃气	疾病
胰腺疾病	疾病
负电位	疾病
抗子宫内膜抗体	疾病
胃潴留	疾病
黑质	疾病
颈动脉体	疾病
膀胱逼尿肌	疾病
胃灼热	疾病
记忆减退	疾病
寒热	疾病
损胃	疾病
多胞胎	疾病
亚砷酸	疾病
毒扁豆碱	疾病
宫缩	疾病
内腔	疾病
心脏传导阻滞	疾病
通乳	疾病
脂代谢	疾病
肝细胞损伤	疾病
腹外斜肌	疾病
保健品	疾病
乙醇中毒	疾病
消食导滞	疾病
肌氨酸酐	疾病
健康膳食	疾病
肾脏疾病	疾病
抽烟	疾病
头发分叉	疾病
熬夜	疾病
健康与疾病	疾病
临产	疾病
水桶腰	疾病
阴道干涩	疾病
卵巢萎缩	疾病
气喘病	疾病
头晕耳鸣	疾病
高血压肾病	疾病
红斑狼疮性肾炎	疾病
睾丸萎缩	疾病
夜盲	疾病
糖尿病并发症	疾病
耳背	疾病
素食者	疾病
缺硒	疾病
先天性疾病	疾病
尿血	疾病
阴阳两虚	疾病
慢性肾病	疾病
温补肾阳	疾病
新生儿核黄疸	疾病
补阳	疾病
群体免疫力	疾病
脱水	疾病
碘中毒	疾病
肾小体	疾病
双肾盂	疾病
非营养素	疾病
等渗尿	疾病
慢性肠炎	疾病
下元亏损	疾病
临床营养学	疾病
鳃节肌	疾病
苍白球	疾病
HBV-DNA	疾病
咳逆上气	疾病
紫癜性肾炎	疾病
单纯性肾囊肿	疾病
获得性肾囊肿	疾病
肾不纳气	疾病
肾髓质	疾病
海洛因	疾病
妊娠毒血症	疾病
蜂毒	疾病
肾阳不振	疾病
成人型多囊肾	疾病
管型	疾病
优生优育	疾病
肾功能受损	疾病
潮热盗汗	疾病
胎龄	疾病
脱屑	疾病
下运动神经元	疾病
皮质延髓束	疾病
门静脉血栓	疾病
间接胆红素	疾病
骨龄	疾病
门静脉血栓形成	疾病
克汀病	疾病
阴毒	疾病
肝囊肿	疾病
伪膜性肠炎	疾病
老年人肝脏	疾病
胆管狭窄	疾病
肝动脉瘤	疾病
怒伤肝	疾病
肝炎后肝硬化	疾病
中毒性肝炎	疾病
化学性肝损伤	疾病
消瘦	疾病
总胆红素	疾病
镰状细胞病	疾病
肝源性糖尿病	疾病
多发性肝囊肿	疾病
葡萄糖耐量	疾病
左侧卧位	疾病
妊娠子宫	疾病
剖宫产	疾病
妊娠期糖尿病	疾病
孕期	疾病
齿龈	疾病
心源性晕厥	疾病
痛	疾病
心脏的传导系统	疾病
早期妊娠	疾病
右侧卧位	疾病
脊髓疾病	疾病
二尖瓣	疾病
三尖瓣	疾病
毛细血管扩张	疾病
亚急性感染性心内膜炎	疾病
肉刺	疾病
气滞血淤	疾病
横纹	疾病
心病	疾病
滑胎	疾病
双胎妊娠	疾病
孕前检查	疾病
阴道出血	疾病
怀孕周期	疾病
氧供	疾病
卧位	疾病
心瓣膜	疾病
心搏停止	疾病
健康体检	疾病
心血管中枢	疾病
血管硬化	疾病
右房室瓣	疾病
冠状动脉	疾病
记忆学	疾病
甲白	疾病
性	疾病
脊髓反射	疾病
G6PD	疾病
常染色体显性遗传病	疾病
居民健康档案	疾病
遗传异质性	疾病
医院内感染	疾病
低聚糖	疾病
肠蠕动	疾病
肾病症候群	疾病
脂蛋白血症	疾病
急性粟粒性肺结核	疾病
间歇热	疾病
酮血症	疾病
长期发热	疾病
急性肾盂肾炎	疾病
双峰热	疾病
类风湿因子	疾病
跛行	疾病
环形红斑	疾病
扁桃体红肿	疾病
少见病	疾病
朗格汉斯细胞组织细胞增生症	疾病
囟门	疾病
尸体腐败	疾病
机械性窒息	疾病
溶血现象	疾病
心烦	疾病
男生	疾病
双重人格	疾病
寒战	疾病
腹胀	疾病
惊恐发作	疾病
催眠疗法	疾病
粪便培养	疾病
溶组织内阿米巴滋养体	疾病
皮肤脓肿	疾病
皮肤阿米巴病	疾病
青霉素脑病	疾病
肺阿米巴病	疾病
钡餐透视	疾病
阿米巴肿	疾病
结肠镜	疾病
阿米巴性肝脓肿	疾病
胆绞痛	疾病
文明病	疾病
黄斑区	疾病
远视散光	疾病
眼球壁	疾病
感染性疾病	疾病
睫状体	疾病
绿内障	疾病
屈光	疾病
不规则散光	疾病
正视眼	疾病
角膜溃疡	疾病
眼角膜	疾病
规则散光	疾病
大环内酯类抗生素	疾病
高度近视	疾病
玻璃体液化	疾病
首都医科大学附属北京同仁医院	疾病
口渴	疾病
胆道蛔虫症	疾病
头项强痛	疾病
表里	疾病
六味地黄丸	疾病
治则	疾病
医德	疾病
奔豚气	疾病
麻腮风三联疫苗	疾病
麻风	疾病
利多卡因	疾病
呼吸控制	疾病
未来人	疾病
尼曼匹克症	疾病
低血容量	疾病
埃博拉出血热	病毒
埃博拉出血热	疾病
血淀粉酶	疾病
肥胖	疾病
感染源	疾病
肛门出血	疾病
负压病房	疾病
内出血	疾病
四川大学华西口腔医院	疾病
四川省肿瘤医院	疾病
血常规	疾病
唇腭裂	疾病
无脑畸形	疾病
TORCH	疾病
结痂	疾病
基础体温	疾病
孕妇保健	疾病
传导性聋	疾病
化脓性中耳炎	疾病
急性化脓性中耳炎	疾病
迷路炎	疾病
外耳道炎	疾病
性紊乱	疾病
恶性口蹄疫	疾病
性健康	疾病
亚急性	疾病
现代文明病	疾病
酶缺乏	疾病
脂质条纹	疾病
生活习惯病	疾病
霉疮秘录	疾病
畸形足	疾病
色盲症	疾病
外伤性骨折	疾病
原虫	疾病
水泡	疾病
腋下	疾病
不治之症	疾病
常染色体隐性遗传病	疾病
多指症	疾病
家族聚集性	疾病
家族性疾病	疾病
死因分析	疾病
正常状态	疾病
皮纹	疾病
Y连锁遗传	疾病
先天性聋哑	疾病
近亲	疾病
线粒体基因病	疾病
隐性遗传病	疾病
掌纹	疾病
异体骨髓移植	疾病
遗传咨询	疾病
红绿色盲	疾病
手掌	疾病
抗维生素D佝偻病	疾病
显性遗传病	疾病
先天性心血管疾病	疾病
单纯性下肢浅静脉曲张	疾病
遗传性球形红细胞增多症	疾病
铜代谢障碍	疾病
黑蒙性白痴	疾病
乳头湿疹	疾病
乳房包块	疾病
伴性遗传病	疾病
口腔	疾病
系谱分析	疾病
青少年型糖尿病	疾病
假肥大型肌营养不良	疾病
最后诊断	疾病
绒毛组织	疾病
遗传性肾炎	疾病
X连锁隐性遗传	疾病
依赖症	疾病
老年人	疾病
家族性白痴病	疾病
精神疾病	疾病
原发性失眠	疾病
光毒性	疾病
紫外线过敏	疾病
坏死性血管炎	疾病
温疹	疾病
血淤	疾病
血瘀证	疾病
虚中夹实	疾病
流涎	疾病
缺陷儿童	疾病
二级预防	疾病
三早	疾病
发病	疾病
小气道	疾病
职业女性	疾病
小儿哮喘	疾病
气管、支气管狭窄	疾病
儿童	疾病
原始反射	疾病
椎动脉	疾病
瘢痕组织	疾病
大脑后动脉	疾病
肢瘫	疾病
盗血综合征	疾病
姿势性低血压	疾病
下橄榄核	疾病
小脑性共济失调	疾病
大脑中动脉	疾病
慢性阻塞性肺疾病	疾病
性感觉	疾病
树突细胞	疾病
小脑扁桃体	疾病
肌紧张	疾病
头胀	疾病
新小脑	疾病
神经核团	疾病
视物模糊	疾病
震颤	疾病
自身免疫性肝炎	疾病
疫苗冷链	疾病
化脓性眼内炎	疾病
眼内炎	疾病
眼内异物	疾病
组织反应	疾病
排异反应	疾病
牙槽骨萎缩	疾病
牙本质	疾病
尖周病	疾病
根管治疗	疾病
急性根尖周炎	疾病
牙周袋	疾病
牙体过敏	疾病
乳齿	疾病
慢性根尖周炎	疾病
异卵双胞胎	疾病
错颌畸形	疾病
狂犬病疫苗	疾病
医疗卫生	疾病
洗牙	疾病
近亲结婚	疾病
神经营养性作用	疾病
传出神经	疾病
血-脑屏障	疾病
睑内翻倒睫	疾病
缺血性坏死	疾病
翼状胬肉	疾病
睑外翻	疾病
百白破疫苗	疾病
白破二联疫苗	疾病
脓皮症	疾病
运动失调	疾病
蜘蛛疮	疾病
严重不良事件	疾病
水痘减毒活疫苗	疾病
风疹疫苗	疾病
血肿	疾病
血液传播	病毒
血液传播	疾病
肝功能异常	疾病
斑疹	疾病
针眼	疾病
腮腺炎疫苗	疾病
大泻	疾病
心慌气短	疾病
防护措施	疾病
听神经	疾病
耳痛	疾病
药物性耳聋	疾病
航空性中耳炎	疾病
恶心	疾病
听力损失	疾病
肾虚耳鸣	疾病
韧带撕裂	疾病
重症联合免疫缺陷病	疾病
人类猪型流感	疾病
虚损	疾病
意识模糊	疾病
第一类疫苗	疾病
气球样变	疾病
溃疡性角膜炎	疾病
内脏	疾病
内脏带状疱疹	疾病
丘疱疹	疾病
眼带状疱疹	疾病
带状疱疹性脑膜炎	疾病
新生儿感染	疾病
胎教	疾病
肠系膜动脉栓塞	疾病
急性盆腔炎	疾病
丙种球蛋白	疾病
老人	疾病
急性出血性坏死性肠炎	疾病
儿童腹痛	疾病
急性腹膜炎	疾病
血清胆红素	疾病
热结腹痛	疾病
盆腔静脉淤血症	疾病
脊髓病变	疾病
休克型肺炎	疾病
记忆力下降	疾病
内脏感觉	疾病
脐中痛	疾病
腹块	疾病
脾破裂	疾病
阴道横隔	疾病
钡灌肠	疾病
早期流产	疾病
唾液	疾病
腹型癫痫	疾病
急性胃扩张	疾病
钙化影	疾病
酮症	疾病
食积腹痛	疾病
幽门梗阻	疾病
下腹坠痛	疾病
输尿管炎	疾病
腹腔积液	疾病
器质性精神病	疾病
绞窄性肠梗阻	疾病
梗阻	疾病
性交	疾病
小便不利	疾病
关节游走性疼痛	疾病
气滞腹痛	疾病
肠系膜淋巴结炎	疾病
腹膜壁层	疾病
宫颈粘连	疾病
血生化检查	疾病
治疗性疫苗	疾病
经期延长	疾病
消化性溃疡病	疾病
蜂螨病	疾病
出血病	疾病
指环虫病	疾病
奶牛焦虫病	疾病
三代虫病	疾病
医疗保健	疾病
美沙酮	疾病
药物依赖性	疾病
病原体	疾病
带状疱疹	病毒
青少年	疾病
呋喃妥因	疾病
五联疫苗	疾病
横贯性脊髓炎	疾病
会厌炎	疾病
阴囊炎	疾病
睑缘炎	疾病
紧张	疾病
核黄素缺乏症	疾病
肾气不足	疾病
利血生	疾病
气阴两虚	疾病
肾为先天之本	疾病
热毒	疾病
悬钟	疾病
司坦唑醇	疾病
温病	疾病
中性粒细胞绝对值	疾病
急诊	疾病
脾肾两虚	疾病
外感发热	疾病
血海	疾病
心慌	疾病
紫河车	疾病
躁狂忧郁症	疾病
春季养生	疾病
运动疲劳	疾病
人体光	疾病
促激素	疾病
苯乙酸睾酮	疾病
面部黄褐斑	疾病
类早孕反应	疾病
撤退性出血	疾病
抗雄激素	疾病
突破性出血	疾病
子宫出血	疾病
羟甲烯龙	疾病
炔雌醇	疾病
呼吸窘迫综合症	疾病
血糖调节	疾病
尸僵	疾病
基本医疗	疾病
骨髓增殖性疾病	疾病
鼻粘膜溃疡	疾病
静止性震颤	疾病
扑翼样震颤	疾病
原发性震颤	疾病
颅脑损伤	疾病
四肢麻木	疾病
慢性消耗性疾病	疾病
二氧化碳潴留	疾病
先天性喉蹼	疾病
舟状腹	疾病
食管闭锁	疾病
呼气性呼吸困难	疾病
意识丧失	疾病
马蹄足	疾病
神经过敏	疾病
甲状腺粉	疾病
呆小病	疾病
原发感染	疾病
蛋白结合碘	疾病
甲状腺结合球蛋白	疾病
甲状腺肥大	疾病
慢性甲状腺炎	疾病
地方性甲状腺肿大	疾病
甲亢症	疾病
粘液性水肿	疾病
周围神经病	疾病
运动系统疾病	疾病
骨代谢病	疾病
肾上腺皮质机能减退	疾病
痧症	疾病
黄汗	疾病
大肠湿热	疾病
非感染性腹泻	疾病
中空器官	疾病
毒瘾	疾病
麦司卡林	疾病
性冲动	疾病
情绪中暑	疾病
自律神经失调	疾病
循环器官	疾病
滋补	疾病
养心安神	疾病
易激惹	疾病
伴性基因	疾病
气逆	疾病
闻诊	疾病
嗅气味	疾病
神经质	疾病
热证	疾病
带下病	疾病
妊娠病	疾病
传变	疾病
头痛病	疾病
慢性疼痛	疾病
天行发斑疮	疾病
疡医	疾病
气陷	疾病
气脱	疾病
流行病学调查	疾病
神经	疾病
胜复	疾病
温病派	疾病
脉学	疾病
头风病	疾病
虚实转化	疾病
外感	疾病
内生五邪	疾病
气血津液	疾病
津伤化燥	疾病
内分泌	疾病
疮疡	疾病
脉诊	疾病
湿温	疾病
望闻问切	疾病
气血失调	疾病
七情	疾病
产后病	疾病
问汗	疾病
辨证	疾病
功能性疾病	疾病
胰腺	疾病
消渴病	疾病
六淫	疾病
经方派	疾病
心室颤动	疾病
补泻	疾病
临床法医学	疾病
脑机接口	疾病
颅脑外伤	疾病
酸碱平衡	疾病
辅助生殖技术	疾病
病理医生	疾病
法医学鉴定	疾病
升汞中毒	疾病
勒死	疾病
杀婴	疾病
职业中毒	疾病
牙科	疾病
法医临床鉴定	疾病
副甲状腺	疾病
成体干细胞	疾病
性恐惧	疾病
梦呓	疾病
鞭虫病	疾病
毛首鞭形线虫	疾病
车祸	疾病
浓茶	疾病
外伤性耳聋	疾病
失能	疾病
侵犯行为	疾病
器官	疾病
劳动能力鉴定	疾病
诈病	疾病
无精子	疾病
恐惧症	疾病
广泛性焦虑障碍	疾病
公共卫生与预防医学	疾病
山西医科大学第二医院	疾病
犬脑炎	疾病
犬传染性肝炎	疾病
犬结核病	疾病
消化不良	疾病
伪狂犬病	疾病
犬瘟热	疾病
幼犬	疾病
秋老虎	疾病
韩素云	疾病
大风	疾病
精神病人	疾病
思维障碍	疾病
周围血管病	疾病
小细胞未分化癌	疾病
哺乳期	疾病
血粘	疾病
肺原性心脏病	疾病
鳞状上皮细胞癌	疾病
脓疮	疾病
囊肿	疾病
水土不服	疾病
萎缩性疤痕	疾病
氯痤疮	疾病
青春期前痤疮	疾病
分叉	疾病
职业性痤疮	疾病
肺炎喘嗽	疾病
上海市第五人民医院	疾病
复旦大学附属妇产科医院	疾病
复旦大学附属金山医院	疾病
手脚发麻	疾病
湖南省肿瘤医院	疾病
浙江省肿瘤医院	疾病
浙江省人民医院	疾病
浙江大学医学院附属儿童医院	疾病
子宫脱垂	疾病
浙江大学医学院附属妇产科医院	疾病
浙江大学医学院附属邵逸夫医院	疾病
肺活量	疾病
甲状腺恶性肿瘤	疾病
上海市肺科医院	疾病
皮肤病与性病学	疾病
普外科	疾病
重庆医科大学附属第二医院	疾病
重庆医科大学附属儿童医院	疾病
重庆医科大学附属第一医院	疾病
损伤	疾病
肾脏	疾病
秋季养生	疾病
新疆维吾尔自治区人民医院	疾病
老花眼	疾病
疾医	疾病
脉经	疾病
治未病	疾病
诸病源候论	疾病
维医	疾病
中医诊断	疾病
胃黏膜	疾病
自然治愈力	疾病
苗医	疾病
医务监督	疾病
内源性非黑素色素沉着	疾病
神经皮肤黑变病	疾病
黑素	疾病
瑞尔黑变病	疾病
黑棘皮病	疾病
斑状白化病	疾病
贫血痣	疾病
皮肤黑热病	疾病
特发性点状白斑	疾病
网状细胞肉瘤	疾病
粘液肉瘤	疾病
脑膜瘤	疾病
骨化性纤维瘤	疾病
脂联素	疾病
软组织肿瘤	疾病
阻塞性肺气肿	疾病
运动系统	疾病
蓝痣	疾病
女阴	疾病
疤痕增生	疾病
手术减重	疾病
色素斑	疾病
局灶性硬皮病	疾病
面部雀斑	疾病
摩擦黑变病	疾病
疾病病因	疾病
黑变病	疾病
增高	疾病
色素减退	疾病
黑色素沉淀	疾病
Becker痣	疾病
炎症后色素沉着	疾病
咖啡斑	疾病
快缩肌纤维	疾病
白肌	疾病
渗出液	疾病
肝脏	疾病
动脉导管	疾病
心肌脂肪变性	疾病
高凝状态	疾病
Mallory小体	疾病
病理性色素沉着	疾病
恶性高血压病	疾病
玻璃样变性	疾病
血管壁玻璃样变性	疾病
纤维素样坏死	疾病
猝死	疾病
肺动脉狭窄	疾病
盆腔脏器脱垂	疾病
肌张力障碍	疾病
膈疝	疾病
呕血	疾病
急性胃粘膜病变	疾病
燕麦细胞癌	疾病
急性糜烂性胃炎	疾病
中央型肺癌	疾病
干骺端	疾病
漏出液	疾病
淤血	疾病
肝淤血	疾病
瓣膜病	疾病
肺淤血	疾病
羊搔痒症	疾病
食管静脉曲张	疾病
毛细血管破裂	疾病
软骨肉瘤	疾病
骨缺损	疾病
骨髓涂片	疾病
肝淀粉样变性	疾病
类脂质渐进性坏死	疾病
信息焦虑	疾病
行军性血红蛋白尿	疾病
免疫性溶血性贫血	疾病
毒蕈中毒	疾病
尿胆红素	疾病
血栓性血小板减少性紫癜	疾病
尿胆原	疾病
类上皮细胞	疾病
腹膜间皮瘤	疾病
病理诊断	疾病
心肌肥大	疾病
立克次氏体	疾病
甲胎蛋白	疾病
自溶	疾病
弥漫性恶性胸膜间皮瘤	疾病
胸膜间皮瘤	疾病
主动脉狭窄	疾病
支气管胸膜瘘	疾病
脑癌	疾病
肺转移瘤	疾病
骨转移	疾病
肺间质	疾病
结肠直肠癌	疾病
寒战	疾病
重度高血压	疾病
管型尿	疾病
肾小球病	疾病
肾间质	疾病
肾小球性蛋白尿	疾病
肾实质性高血压	疾病
肾性高血压	疾病
内生肌酐清除率	疾病
肾小球疾病	疾病
肾素-血管紧张素系统	疾病
焦虑	疾病
急性间质性肾炎	疾病
尿沉渣	疾病
肾小球硬化	疾病
肾静脉血栓形成	疾病
膑骨	疾病
免疫系统紊乱	疾病
一期愈合	疾病
马鼻疽	病毒
马鼻疽	疾病
洗肾	疾病
酒精依赖症	疾病
溶组织内阿米巴	疾病
汤火伤	疾病
肝片吸虫病	疾病
禽结核病	疾病
猪囊尾蚴病	疾病
神经损伤	疾病
鼻缺损	疾病
驼峰鼻	疾病
皮肤溃烂	疾病
效果评价	疾病
合理膳食	疾病
疖肿	疾病
外鼻	疾病
眼底病变	疾病
周围神经病变	疾病
淋巴细胞归巢	疾病
下肢溃疡	疾病
NKT细胞	疾病
细胞癌	疾病
放化疗	疾病
失血性休克	疾病
眼睛	疾病
四肢血管损伤	疾病
长效干扰素	疾病
人工心脏起搏	疾病
胸片	疾病
心脏肥大	疾病
心源性昏厥	疾病
阵发性房颤	疾病
肝硬化顽固性腹水	疾病
中度贫血	疾病
肥大细胞增生症	疾病
肾衰竭	疾病
速发型过敏反应	疾病
Whipple病	疾病
间质瘤	疾病
下肢瘫痪	疾病
肺痶	疾病
四害	疾病
乙脑疫苗	疾病
乳头溢液	疾病
遗传性乳腺癌	疾病
乳腺导管扩张症	疾病
肿瘤	疾病
梨形鞭毛虫	疾病
胼胝	疾病
外周血管疾病	疾病
体内湿热	疾病
化生	疾病
丘疹	疾病
口撮	疾病
中枢抑制	疾病
无精子症	疾病
粪便检查	疾病
不育症	疾病
经血	疾病
阿片肽	疾病
酮尿症	疾病
恶性组织细胞病	疾病
精神发育迟滞	疾病
尿路结石	疾病
病理过程	疾病
微孢子虫病	疾病
糖尿病性神经病	疾病
冠状动脉疾病	疾病
早老性痴呆	疾病
营养状态	疾病
罹患率	疾病
麻痹性贝毒	疾病
缺血再灌注	疾病
疤痕体质	疾病
气肿	疾病
女性生理期	疾病
灼热	疾病
肿	疾病
面部红血丝	疾病
肠炎病	疾病
验光	疾病
备孕	疾病
失眠	疾病
产科	疾病
药物流产	疾病
α1-抗胰蛋白酶缺乏症	疾病
酪氨酸血症	疾病
痴呆症	疾病
慢粒急变	疾病
育儿	疾病
干细胞移植	疾病
骨性关节病	疾病
感染性关节炎	疾病
异体移植	疾病
静脉输液	疾病
循环血量	疾病
混合性结缔组织病	疾病
强迫性人格	疾病
色素组织	疾病
摄食中枢	疾病
化学烧伤	疾病
浮肿	疾病
色素性视网膜炎	疾病
激素释放因子	疾病
视交叉上核	疾病
颅内动脉瘤	疾病
内斜视	疾病
性教育	疾病
畸形发育	疾病
c-kit受体	疾病
C57BL/6	疾病
第一性征	疾病
功能性子宫出血	疾病
性欲低下	疾病
卵泡破裂	疾病
活动性肝炎	疾病
遗传病	疾病
输卵管伞	疾病
卵子	疾病
自体骨髓移植	疾病
舒降之	疾病
胀痛	疾病
B超	疾病
肝腹水	疾病
高血钠症	疾病
失眠症	疾病
血管壁	疾病
肝病面容	疾病
肝细胞凋亡	疾病
肝病饮食	疾病
咳嗽痰多	疾病
轻度脂肪肝	疾病
肝胆湿热	疾病
急性乙肝	疾病
腹腔脓肿	疾病
颌下腺炎	疾病
荨麻疹	疾病
重大传染病疫情	疾病
血小板源生长因子	疾病
GFAP	疾病
飞沫传染	疾病
元气不足	疾病
甲型H1N1流感监测方案	疾病
疾病监测	疾病
糖尿病行为医学技术指南	疾病
奇病论	疾病
乙肝疫苗	疾病
谷物保护曲线	疾病
消渴症	疾病
双高综合症	疾病
缩窄性心包炎	疾病
Langerhans细胞	疾病
氧气疗法	疾病
癌前病变	疾病
发病学	疾病
上运动神经元	疾病
禁忌症	疾病
梭形细胞	疾病
虫媒	疾病
口腔基础医学	疾病
人体解剖与组织胚胎学	疾病
功能神经外科	疾病
X线	疾病
胎死宫内	疾病
肘外翻	疾病
内基氏小体	病毒
内基氏小体	疾病
百日咳	疾病
哮喘	疾病
呼吸性酸中毒	疾病
二氧化碳结合力	疾病
病理产物	疾病
黄体期	疾病
无排卵	疾病
中毒性白内障	疾病
年龄相关性白内障	疾病
并发性白内障	疾病
代谢性白内障	疾病
外伤性白内障	疾病
心力衰竭细胞	疾病
分泌上皮	疾病
肺换气	疾病
阿的平	疾病
视神经乳头水肿	疾病
上丘脑	疾病
结合珠蛋白	疾病
紫癜	疾病
单核细胞白血病	疾病
冷球蛋白血症	疾病
重链病	疾病
习惯性流产	疾病
子宫内膜异位	疾病
气道过敏性炎症	疾病
耳硬化症	疾病
精神科	疾病
乳房下垂	疾病
节育环	疾病
染色体畸变	疾病
下肢静脉血栓	疾病
痰中	疾病
咯痰	疾病
排酸	疾病
痰血	疾病
人工气道	疾病
空气栓塞	疾病
结核结节	疾病
癌栓	疾病
脑软化	疾病
石棉肺	疾病
喉痉挛	疾病
急性支气管炎	疾病
生产性粉尘	疾病
纵隔镜检查	疾病
肺囊性纤维化	疾病
纵隔淋巴结	疾病
胸腔穿刺	疾病
上气道	疾病
小脑	疾病
纵隔疾病	疾病
肺间质纤维化	疾病
支气管癌	疾病
骨髓干抽	疾病
急慢性肝炎	疾病
支气管镜	疾病
横纹肌肉瘤	疾病
先兆子痫	疾病
分泌性蛋白	疾病
优势比	疾病
IGF-1	疾病
范可尼贫血	疾病
角化过度	疾病
上皮瘤	疾病
鳞状上皮癌	疾病
摄取胺前体脱羧细胞	疾病
导气	疾病
毛细支气管炎	疾病
腓反射	疾病
钙代谢紊乱	疾病
高磷酸盐血症	疾病
新生儿低钙血症	疾病
产前出血	疾病
HBsAg携带者	疾病
乙肝e抗体	疾病
急性乙型肝炎	疾病
乙肝潜伏期	疾病
乙肝表面抗原阳性	疾病
乙肝核心抗体	疾病
急性肝炎	疾病
乙肝五项指标	疾病
汗液	疾病
腺样囊性癌	疾病
良性肿瘤	疾病
炎性乳腺癌	疾病
乳房结核	疾病
小叶原位癌	疾病
粘液腺癌	疾病
乳腺小叶增生	疾病
红细胞凝集素	疾病
臂丛神经	疾病
慢性乳腺炎	疾病
乳房悬韧带	疾病
乳腺肉瘤	疾病
导管内乳头状瘤	疾病
淋巴肉瘤	疾病
良性病变	疾病
乳痛症	疾病
非哺乳期乳腺炎	疾病
乳腺恶性淋巴瘤	疾病
肿瘤免疫	疾病
膨胀性生长	疾病
乳房疼痛	疾病
橘皮征	疾病
浆细胞性乳腺炎	疾病
小叶增生	疾病
转移性腺癌	疾病
乳腺纤维肉瘤	疾病
伤寒病	疾病
室颤	疾病
心律紊乱	疾病
基因咨询	疾病
湿啰音	疾病
一氧化碳中毒迟发性脑病	疾病
假性球麻痹	疾病
皮肤科医生	疾病
过敏原测试	疾病
过敏性休克	疾病
恶性心律失常	疾病
再灌注性心律失常	疾病
唇疱疹	疾病
软骨发育不全	疾病
鸭瘟	疾病
泼尼松龙	疾病
马立克氏病	病毒
马立克氏病	疾病
面神经瘫痪	疾病
蝶形红斑	疾病
交感性眼炎	疾病
疱疹样皮炎	疾病
REM睡眠	疾病
脑苷脂沉积病	疾病
上海中医药大学附属曙光医院	疾病
动物医学进展	疾病
缺钾	疾病
脱血	疾病
代谢性碱中毒	疾病
补液	疾病
视网膜母细胞瘤	疾病
眼球穿通伤	疾病
反常性酸性尿	疾病
bt	疾病
高血钾症	疾病
周期性麻痹	疾病
慢性肾功能不全	疾病
颅神经	疾病
奥氮平	疾病
退伍军人症	病毒
退伍军人症	疾病
润肺止咳	疾病
原位癌	疾病
继发性感染	疾病
闭孔神经	疾病
宫颈刮片	疾病
宫颈原位癌	疾病
宫颈活检	疾病
鳞状细胞	疾病
鳞状上皮化生	疾病
宫颈妊娠	疾病
宫颈腺癌	疾病
非典型增生	疾病
宫颈肥大	疾病
阴道涂片	疾病
宫颈性不孕	疾病
切片检查	疾病
淋巴囊肿	疾病
包皮垢	疾病
辅助生育技术	疾病
坐骨直肠窝	疾病
牙齿	疾病
滴虫性尿道炎	疾病
阴道穹	疾病
单纯性阴道炎	疾病
性反应	疾病
外阴损伤	疾病
产褥期	疾病
功血	疾病
性早熟	疾病
阴道穹窿	疾病
婴幼儿阴道炎	疾病
月经性阴道炎	疾病
子宫颈息肉	疾病
化脓性阴道炎	疾病
经量	疾病
心血	疾病
血清病	疾病
三碘甲状腺原氨酸	疾病
血浆置换	疾病
原发性纤溶亢进	疾病
继发性纤溶亢进	疾病
纤溶亢进	疾病
水潴留	疾病
硼酸中毒	疾病
高钠血症	疾病
尿钾	疾病
X线机	疾病
血清抗体	疾病
带状皰疹	疾病
电击	疾病
中性粒细胞核左移	疾病
下尿路感染	疾病
上尿路感染	疾病
尿路梗阻	疾病
前列腺结石	疾病
神经源性膀胱	疾病
脓尿	疾病
尿液检查	疾病
疫苗注射	疾病
维生素C缺乏症	疾病
开裆裤	疾病
舟状窝	疾病
尿生殖膈	疾病
排尿	疾病
后尿道	疾病
淋巴腺	疾病
钙化	疾病
胰高血糖素样肽-1	疾病
分泌神经	疾病
眼部化学伤	疾病
餐后血糖	疾病
急性闭角型青光眼	疾病
颅内高压	疾病
条件性感染	疾病
艾滋病潜伏期	疾病
艾滋病疫苗	疾病
Kaposis肉瘤	疾病
过敏	疾病
代孕	疾病
肉鸡	疾病
氢化可的松	疾病
Balb/c小鼠	疾病
减压神经	疾病
传染性貂脑病	疾病
鸡新城疫	疾病
疾病爆发	疾病
排乳	疾病
雌孕激素	疾病
高睾酮血症	疾病
孕吐	疾病
最佳生育年龄	疾病
百白破	疾病
原发性闭经	疾病
转氨酶偏高	疾病
γ-谷氨酰转肽酶	疾病
胆道系统	疾病
肝脏外伤	疾病
谷丙转氨酶高	疾病
转氨酶过高	疾病
性心理障碍	疾病
精神失常	疾病
水痘疫苗	疾病
临床兽医学	疾病
叹息样呼吸	疾病
三凹征	疾病
搐搦症	疾病
自发性气胸	疾病
混合性呼吸困难	疾病
急性纵隔炎	疾病
手心	疾病
声门水肿	疾病
睡眠习惯	疾病
眼球运动障碍	疾病
硫化血红蛋白血症	疾病
咽后壁脓肿	疾病
鼻毛	疾病
潮式呼吸	疾病
并指畸形	疾病
筋膜炎	疾病
健康保健	疾病
先天性多指、趾畸形	疾病
甲肝疫苗	疾病
手外伤	疾病
化脓性指头炎	疾病
复合伤	疾病
理工	疾病
天津市胸科医院	疾病
口腔肿瘤	疾病
头颈部肿瘤	疾病
湖北省肿瘤医院	疾病
成胶质细胞瘤	疾病
多形性胶质母细胞瘤	疾病
膝关节	疾病
中枢性瘫痪	疾病
原始神经外胚层肿瘤	疾病
伊马替尼	疾病
真性延髓麻痹	疾病
少枝胶质细胞瘤	疾病
脑梗阻	疾病
后组颅神经	疾病
延髓背外侧综合症	疾病
低度恶性肿瘤	疾病
伸舌	疾病
听力	疾病
间变	疾病
神经功能障碍	疾病
静脉栓塞	疾病
细胞周期非特异性药物	疾病
口腔粘膜炎	疾病
肝肿大	疾病
细胞周期特异性药物	疾病
艾迪生氏病	疾病
白秃疮	疾病
肿瘤发生	疾病
眼球表面异物	疾病
鼻窦癌	疾病
骨痂	疾病
急性光气中毒	疾病
性连锁遗传病	疾病
甘油三酯偏高	疾病
全色盲	疾病
家族性多发性结肠息肉	疾病
基本病理过程	疾病
无胸腺裸鼠	疾病
血友病乙	疾病
香港流感	疾病
痿黄	疾病
关节畸形	疾病
凝血活酶生成试验	疾病
血证	疾病
原因不明性巨球蛋白血症	疾病
缺氧症状	疾病
血友病甲	疾病
单纯红细胞再生障碍性贫血	疾病
血管性假血友病	疾病
性淋巴肉芽肿	疾病
脑外伤	疾病
乌脚病	疾病
嗜酸性粒细胞增生性淋巴肉芽肿	疾病
健忘	疾病
苯系物	疾病
维吾尔族医学	疾病
藏族医学	疾病
五风	疾病
升阳	疾病
医学心理学	疾病
人体胚胎学	疾病
流感疫苗	疾病
蜕膜组织	疾病
胎盘膜	疾病
腹膜腔	疾病
寄生胎	疾病
鼠疫疫苗	疾病
产后缺乳	疾病
胶质瘢痕	疾病
弱精症	疾病
免疫缺陷病	疾病
胚胎冷冻	疾病
输卵管结核	疾病
免疫性不孕症	疾病
忽略性横位	疾病
肌瘤	疾病
外阴癌	疾病
双阴道	疾病
继发性不孕	疾病
膀胱损伤	疾病
过敏史	疾病
子宫发育不良	疾病
子宫峡	疾病
性交出血	疾病
先天性无子宫	疾病
阴道纵隔	疾病
肛门坠胀	疾病
子宫穿孔	疾病
腹疼	疾病
cccDNA	疾病
放射性药品	疾病
药源性疾病	疾病
永久性细胞	疾病
心脏瓣膜	疾病
自体干细胞	疾病
人造血	疾病
人造心脏	疾病
性欲障碍	疾病
正分子医学	疾病
重大动物疫病	疾病
人文科学	疾病
口周皮炎	疾病
角质层受损	疾病
化妆品过敏综合症	疾病
联合反应	疾病
公主病	疾病
色素性化妆品皮炎	疾病
痉挛性咳嗽	疾病
利胆	疾病
免疫性疾病	疾病
木犀草素	疾病
恶性淋巴癌	疾病
强碱中毒	疾病
强酸烧伤	疾病
强碱类中毒	疾病
强酸类中毒	疾病
眼烧伤	疾病
强碱烧伤	疾病
神经性头痛	疾病
G点	疾病
外阴尖锐湿疣	疾病
虹膜异色症	疾病
维生素E缺乏症	疾病
冻伤	疾病
健康老人	疾病
精子活力	疾病
肺病	疾病
根肿病	疾病
冬泳	疾病
免疫病理学	疾病
HIB疫苗	疾病
数码视觉疲劳	疾病
松果体素	疾病
睡懒觉	疾病
瞌睡	疾病
时间药理学	疾病
植物人	疾病
环丙氟哌酸	疾病
宣肺	疾病
肺痈	疾病
缺血性脑卒中	疾病
脊髓炎	疾病
胸痹心痛	疾病
缺血性脑水肿	疾病
脑缺血	疾病
节律障碍	疾病
窦性停搏	疾病
痈肿	疾病
内痈	疾病
目赤肿痛	疾病
小便淋沥	疾病
无名肿毒	疾病
钙离子	疾病
疔疮	疾病
四诊八纲	疾病
气管镜	疾病
肠镜	疾病
乙状结肠镜检查	疾病
小肠结肠炎	疾病
烧伤感染	疾病
阳性体征	疾病
卵磷脂小体	疾病
阴道清洁度检查	疾病
维生素b2	疾病
大便隐血试验	疾病
睾丸畸胎瘤	疾病
妇科肿瘤	疾病
中药药理	疾病
血清谷丙转氨酶	疾病
脑力劳动者	疾病
呕吐反射	疾病
脓毒败血症	疾病
心动过缓	疾病
小儿支气管哮喘	疾病
白细胞减少	疾病
二对半	疾病
毛发红糠疹	疾病
新生儿流行性腹泻	疾病
肛门闭锁	疾病
脊柱畸形	疾病
行走反射	疾病
晚发	疾病
寒冷损伤	疾病
夜啼	疾病
正铁血红蛋白血症	疾病
卡介苗	疾病
验血	疾病
中西医结合基础	疾病
护膝	疾病
风痹	疾病
红兔毛水晶	疾病
男同性恋	疾病
进食障碍	疾病
冷辐射	疾病
阴道闭锁	疾病
平胸	疾病
小儿肺炎	疾病
性行为异常	疾病
急性伤害	疾病
暴发性紫癜	疾病
D-二聚体	疾病
血液酸碱度	疾病
早产儿奶粉	疾病
痛阈	疾病
四氯化碳中毒	疾病
肌肉代谢	疾病
偏头疼	疾病
非结合胆汁酸	疾病
血清碱性磷酸酶	疾病
脂肪痢	疾病
空腹血糖	疾病
新生儿肝炎	疾病
腺瘤性息肉	疾病
总胆汁酸	疾病
γ-谷氨酰转移酶	疾病
分年龄死亡率	疾病
类胰蛋白酶	疾病
霍乱疫情	疾病
声音嘶哑	疾病
不良饮食习惯	疾病
下消化道出血	疾病
羌虫病	疾病
家族性混合型高脂血症	疾病
牙齿变形	疾病
眼屎	疾病
鼻屎	疾病
黄染	疾病
创伤性神经瘤	疾病
瘢痕修复	疾病
糖尿病坏疽	疾病
肌肉营养不良	疾病
黄斑变性	疾病
蝎虱病	疾病
肠绒毛	疾病
要素饮食	疾病
肠道狭窄	疾病
抗核抗体	疾病
猩红热	疾病
急性腹痛	疾病
肠瘘	疾病
房间隔	疾病
胸膜顶	疾病
腹横肌	疾病
右淋巴导管	疾病
乳头肌功能不全	疾病
黄赌毒	疾病
萎黄	疾病
性激素	疾病
先补后攻	疾病
苯乙尿酸	疾病
苏拉病	疾病
睡眠病	疾病
特发性癫痫	疾病
缺血性脑血管病	疾病
脂质代谢异常	疾病
新产	疾病
梗死	疾病
失稳	疾病
肌肉松弛	疾病
铁树果	疾病
临床药学	疾病
Solanum	病毒
Solanum	疾病
脐带异常	疾病
瘴气	疾病
日本乙型脑炎	疾病
痰结	疾病
散白蚁	疾病
磺胺间甲氧嘧啶	疾病
口唇疱疹	疾病
神经性毒素	疾病
地塞米松抑制试验	疾病
滤过作用	疾病
肾上腺皮质腺瘤	疾病
肾上腺皮质功能不全	疾病
肾上腺增生	疾病
假两性畸形	疾病
钙化灶	疾病
肾上腺肿瘤	疾病
肺小细胞癌	疾病
造血器官	疾病
子宫萎缩	疾病
反应性低血糖	疾病
垂体微腺瘤	疾病
皮质醇分泌率	疾病
葵酸诺龙	疾病
原发癌	疾病
癌家族	疾病
远端转移	疾病
染色体缺失	疾病
肌肉震颤	疾病
管状腺瘤	疾病
癌前疾病	疾病
绒毛状腺瘤	疾病
ras基因	疾病
小细胞肺癌	疾病
头颈癌	疾病
病态	疾病
人类染色体	疾病
干扰作用	病毒
干扰作用	疾病
染色体疾病	疾病
成熟卵泡	疾病
姑息治疗	疾病
血液净化	疾病
临床病理讨论会	疾病
电子计算机X线断层扫描机	疾病
望诊	疾病
外科	疾病
医患关系	疾病
老年人慢性肾功能衰竭	疾病
急性病	疾病
老年人慢性胃炎	疾病
老年人肺炎	疾病
脑血管硬化	疾病
主诉	疾病
老年人肺癌	疾病
老年人急性肾功能衰竭	疾病
老年人消化性溃疡	疾病
窒息	疾病
老年人尿路感染	疾病
老年人肺结核	疾病
老年人心力衰竭	疾病
老年人钙化性瓣膜病	疾病
坠积性肺炎	疾病
心脏骤停与心肺脑复苏	疾病
腰椎骨折	疾病
椎间盘脱出	疾病
甲状腺激素	疾病
血管内皮损伤	疾病
骨关节疾病	疾病
远程会诊	疾病
中心型肺癌	疾病
喉水肿	疾病
胸腺增生	疾病
胃肠钡餐检查	疾病
平扫	疾病
自然对比	疾病
疫苗	疾病
肌细胞	疾病
妇科恶性肿瘤	疾病
实体瘤	疾病
肿瘤性增生	疾病
癌性疼痛	疾病
叩诊	疾病
干细胞治疗强直性脊柱炎	疾病
间充质干细胞	疾病
神经干细胞移植	疾病
急性放射病	疾病
干细胞治疗脊髓损伤	疾病
世界艾滋病日	疾病
干细胞移植治疗	疾病
人类造血干细胞	疾病
代偿期肝硬化	疾病
大小便失禁	疾病
自体干细胞移植	疾病
武学文	疾病
温病学派	疾病
三元理论	疾病
中医医生	疾病
血热	疾病
异病同治	疾病
三元医学理论	疾病
透疹	疾病
阴阳辨证	疾病
阴虚则内热	疾病
五科	疾病
卫气营血辨证	疾病
小方脉	疾病
十三科	疾病
恋爱恐惧症	疾病
虚嗽	疾病
舌象	疾病
邪正消长	疾病
忌口	疾病
同病异治	疾病
出血点	疾病
食欲亢进	疾病
扁桃体肿大	疾病
急症	疾病
女性性功能障碍	疾病
输卵管发育异常	疾病
生殖道瘘	疾病
女性生殖内分泌疾病	疾病
盆腔炎性疾病	疾病
滋养细胞肿瘤	疾病
胎儿窘迫	疾病
外阴硬化性苔癣	疾病
下腹部肿块	疾病
危害	疾病
输卵管肿瘤	疾病
阴道肿瘤	疾病
羊水检查	疾病
阴道上皮内瘤样变	疾病
产褥中暑	疾病
性反应周期	疾病
羊水量异常	疾病
胆石病	疾病
手机依赖症	疾病
先兆临产	疾病
产道异常	疾病
子宫破裂	疾病
胎盘部位滋养细胞肿瘤	疾病
高催乳激素血症	疾病
外阴皮肤病	疾病
晚期产后出血	疾病
阴道发育异常	疾病
观察诊断	疾病
血液滤过	疾病
血液灌流	疾病
遗传性肿瘤综合征	疾病
血红蛋白病	疾病
先天性代谢缺陷	疾病
肿瘤遗传学	疾病
呼吸音	疾病
肌束颤动	疾病
皮下气肿	疾病
周细胞	疾病
支气管扩张症	疾病
心脏彩超	疾病
关节内游离体	疾病
运动损伤	疾病
医疗体育	疾病
前交叉韧带损伤	疾病
运动伤病	疾病
功能障碍	疾病
小儿急性喉炎	疾病
硬皮病	疾病
生存率	疾病
预后可疑	疾病
病种	疾病
上医	疾病
病残率	疾病
哮喘发作	疾病
医疗技术	疾病
小肠恶性肿瘤	疾病
自限性疾病	疾病
小肠肿瘤	疾病
动物疾病	疾病
虚胖	疾病
战汗	疾病
问妇女	疾病
崩漏	疾病
水泻	疾病
灼痛	疾病
瘀血内停	疾病
寒热往来	疾病
口淡	疾病
虫积	疾病
动脉粥样硬化	疾病
寒证	疾病
痰浊中阻	疾病
少阴头痛	疾病
吐酸	疾病
心血不足	疾病
中气不足	疾病
恶寒发热	疾病
痛如针刺	疾病
身热不扬	疾病
脏躁	疾病
假小叶	疾病
气淋	疾病
十问歌	疾病
脾虚湿盛	疾病
小腹痛	疾病
问二便	疾病
产后发热	疾病
月经先期	疾病
肠痈	疾病
表证	疾病
肺气虚	疾病
萎缩性硬化性苔藓	疾病
夜尿	疾病
膏淋	疾病
绝汗	疾病
形寒	疾病
寒邪	疾病
胸胁	疾病
妊娠恶阻	疾病
痰浊	疾病
脾气虚	疾病
吐酸水	疾病
神经系统肿瘤	疾病
半表半里证	疾病
少阳证	疾病
胃中积热	疾病
壮热	疾病
肾精	疾病
热淋	疾病
骨蒸潮热	疾病
腹满	疾病
苔腻	疾病
尿流中断	疾病
胞浆	疾病
少腹痛	疾病
肝郁气滞	疾病
产后热	疾病
水逆	疾病
风邪	疾病
问饮食	疾病
问寒热	疾病
血崩	疾病
恶热	疾病
问头身	疾病
伤寒肉芽肿	疾病
湿证	疾病
口舌生疮	疾病
热结	疾病
吐脓血	疾病
阳明头痛	疾病
牙龈肿痛	疾病
五心烦热	疾病
石淋	疾病
问睡眠	疾病
热盛伤津	疾病
腺泡状软组织肉瘤	疾病
太阴头痛	疾病
梦遗	疾病
情志	疾病
胃阴不足	疾病
气虚证	疾病
少阳头痛	疾病
胃脘饱胀	疾病
气虚不摄	疾病
肝火	疾病
骨蒸	疾病
湿热内蕴	疾病
心主血脉	疾病
唾沫	疾病
阴疮	疾病
头软	疾病
舌诊	疾病
五轮	疾病
小儿指纹	疾病
望舌	疾病
色素沉着	疾病
凹甲	疾病
气血不足	疾病
湿热内盛	疾病
阴黄	疾病
解颅	疾病
五轮八廓	疾病
望五官	疾病
外障	疾病
疠风	疾病
望形态	疾病
羊炭疽病	疾病
现代免疫学	疾病
神经母细胞瘤	疾病
舌苔腻	疾病
望神	疾病
暑湿	疾病
回光返照	疾病
阴挺	疾病
假神	疾病
睑废	疾病
项软	疾病
五体	疾病
寒湿困脾	疾病
炎症细胞	疾病
透关射甲	疾病
热伤肺络	疾病
疳疾	疾病
肺胃热盛	疾病
五脏相关	疾病
囟陷	疾病
五色带	疾病
囟填	疾病
栓子	疾病
阳黄	疾病
望色	疾病
阴缩	疾病
脾火	疾病
望齿	疾病
矿元素	疾病
精索鞘膜积液	疾病
畸形	疾病
自愈	疾病
泌尿外科	疾病
变性	疾病
矫形外科	疾病
血管外科	疾病
心身疾病	疾病
人格障碍	疾病
寄生虫学	疾病
腹诊	疾病
包皮系带	疾病
包皮粘连	疾病
阴茎头包皮炎	疾病
瘤样病变	疾病
回顾性调查	疾病
现况调查	疾病
社会病	疾病
转归	疾病
高危性行为	疾病
第三次卫生革命	疾病
第一次卫生革命	疾病
健康行为	疾病
第二次卫生革命	疾病
暴力伤医	疾病
皮肤松弛症	疾病
磁共振系统	疾病
肿瘤分期	疾病
十字韧带损伤	疾病
纵隔疝	疾病
玻璃体疾病	疾病
肘关节脱位	疾病
巩膜病	疾病
玻璃体病	疾病
胃粘膜	疾病
花粉热	疾病
视神经损害	疾病
急性流行性结膜炎	疾病
Fuchs综合征	疾病
眼睑病	疾病
结膜病	疾病
葡萄膜病	疾病
角膜疾病	疾病
单纯性表层巩膜炎	疾病
视光学	疾病
未分化癌	疾病
眼肌	疾病
眼部充血	疾病
角膜病	疾病
视网膜疾病	疾病
眼肿瘤	疾病
眼科检查	疾病
眼表疾病	疾病
葡萄膜疾病	疾病
视路	疾病
品行障碍	疾病
糖原沉着症	疾病
恐惧性焦虑障碍	疾病
梅毒所致精神障碍	疾病
脑器质性精神障碍	疾病
脑外伤所致精神障碍	疾病
周期性瘫痪	疾病
高血粘	疾病
艾滋病的神经系统病变	疾病
三叉神经根	疾病
习惯性便秘	疾病
血管内皮细胞瘤	疾病
角回	疾病
良性颅内压增高	疾病
脊神经根炎	疾病
脊髓血管疾病	疾病
肌肉疾病	疾病
失认	疾病
颅神经损害	疾病
神经康复	疾病
脊髓亚急性联合变性	疾病
乙型肝炎表面抗原	疾病
慢性活动性肝炎	疾病
运动障碍疾病	疾病
中枢神经系统脱髓鞘疾病	疾病
钝痛	疾病
脊椎病	疾病
感觉性失语症	疾病
神经皮肤综合征	疾病
脱髓鞘疾病	疾病
后侧索联合变性	疾病
上运动神经元性瘫痪	疾病
脊神经节	疾病
碎片状坏死	疾病
深感觉	疾病
性治疗	疾病
周围神经疾病	疾病
经颅多普勒	疾病
眶上神经痛	疾病
失认症	疾病
放射性脊髓病	疾病
原发性三叉神经痛	疾病
膝状神经节	疾病
面肌萎缩	疾病
淤血	疾病
髓内肿瘤	疾病
感觉性失语	疾病
艾滋病神经系统损害	疾病
腱反射	疾病
脑磁图	疾病
星状神经节阻滞	疾病
脊髓血管病	疾病
空洞症	疾病
继发性三叉神经痛	疾病
颅脑CT	疾病
脂肪栓塞	疾病
构音障碍	疾病
紧张型头痛	疾病
枕大神经痛	疾病
扳机点	疾病
体象障碍	疾病
急性播散性脑脊髓炎	疾病
小舞蹈症	疾病
脊髓前角灰质炎	疾病
失用症	疾病
放射性疼痛	疾病
脂肪变性	疾病
分离性感觉障碍	疾病
认知障碍	疾病
感觉性共济失调	疾病
弥漫性硬化	疾病
锥体外系统	疾病
小舞蹈病	疾病
运动性失语症	疾病
副肿瘤综合征	疾病
脑白质营养不良	疾病
亨廷顿病	疾病
定性诊断	疾病
过敏性体质	疾病
原发性免疫缺陷病	疾病
完全性大动脉转位	疾病
脐肉芽肿	疾病
学习障碍	疾病
内脏脂肪	疾病
心跳呼吸骤停	疾病
蛋白质能量营养不良	疾病
幼年特发性关节炎	疾病
上皮性肿瘤	疾病
先天性甲状腺功能减低症	疾病
发作性睡病	疾病
新生儿脐部疾病	疾病
小于胎龄儿	疾病
心内膜弹力纤维增生症	疾病
维生素A过多症	疾病
急性感染性喉炎	疾病
儿童铅中毒	疾病
小儿急性中毒	疾病
tourette综合征	疾病
含铁血黄素	疾病
肺吸虫病	疾病
原发型肺结核	疾病
贾弟虫病	疾病
维生素缺乏	疾病
急性上呼吸道感染	疾病
出疹性疾病	疾病
缺血缺氧性脑病	疾病
新生儿衣原体感染	疾病
心肌疾病	疾病
心肌	疾病
儿童1型糖尿病	疾病
新生儿产伤性疾病	疾病
新生儿窒息	疾病
小儿颅内出血	疾病
新生儿重症监护	疾病
神经性贪食症	疾病
小儿特发性肺含铁血黄素沉着症	疾病
微量元素障碍	疾病
行为障碍	疾病
近端肾小管	疾病
泡沫细胞	疾病
小儿脑肿瘤	疾病
臂丛神经麻痹	疾病
上气道梗阻	疾病
幼年型皮肌炎	疾病
小儿心肺复苏	疾病
头颅血肿	疾病
新生儿出血症	疾病
婴儿食物	疾病
先天性弓形虫感染	疾病
破伤风毒素	疾病
间皮瘤	疾病
小儿肥胖症	疾病
营养性疾病	疾病
幼年类风湿	疾病
伤寒与副伤寒	疾病
维生素营养障碍	疾病
产伤	疾病
原发性肾病综合征	疾病
生长激素缺乏症	疾病
反流性肾病	疾病
黄瘤	疾病
锌缺乏症	疾病
新生儿坏死性小肠结肠炎	疾病
新生儿高血糖	疾病
先天性肥厚性幽门狭窄	疾病
饮食障碍	疾病
急性中毒性脑病	疾病
小儿腹泻病	疾病
小儿热性惊厥	疾病
滤泡性淋巴瘤	疾病
新生儿脐炎	疾病
维生素D缺乏性手足搐搦症	疾病
婴儿肝炎综合征	疾病
儿童单纯性肥胖症	疾病
红细胞葡萄糖-6-磷酸脱氢酶缺乏症	疾病
新生儿感染性肺炎	疾病
自发性蛛网膜下腔出血	疾病
先天性直肠肛管畸形	疾病
椎体骨软骨病	疾病
急性化脓性腱鞘炎	疾病
转移癌	疾病
乳管内乳头状瘤	疾病
皮肤乳头状瘤	疾病
感染性皮肤病	疾病
下肢慢性静脉功能不全	疾病
泌尿系统梗阻	疾病
急性化脓性腹膜炎	疾病
肝外胆管结石	疾病
颞下颌关节脱位	疾病
皮下急性蜂窝织炎	疾病
脂肪肉瘤	疾病
手掌深部间隙感染	疾病
尿石症	疾病
动脉硬化性闭塞症	疾病
手部损伤	疾病
胃十二指肠溃疡	疾病
食管良性肿瘤	疾病
非冻结性冷伤	疾病
粘连性肠梗阻	疾病
血色病	疾病
脑淤血	疾病
切口疝	疾病
急性梗阻性化脓性胆管炎	疾病
急性弥漫性腹膜炎	疾病
周围血管损伤	疾病
非特异性肋软骨炎	疾病
原发性甲状旁腺功能亢进	疾病
急性淋巴管炎	疾病
全身性外科感染	疾病
肾小球	疾病
SPECT	疾病
骨与关节结核	疾病
心瓣膜病	疾病
反常性碱性尿	疾病
高镁血症	疾病
急性化脓性甲状腺炎	疾病
化脓性颌骨骨髓炎	疾病
医学综合笔试	疾病
中位年龄	疾病
淋巴管	疾病
口眼歪斜	疾病
进行性吞咽困难	疾病
股骨干骨折	疾病
颅骨缺损	疾病
肠麻痹	疾病
种群瓶颈	疾病
健康老龄化	疾病
肾上腺髓质	疾病
氮质血症	疾病
血常规检查	疾病
药物排泄	疾病
尿酮体	疾病
血清肌酐	疾病
尿蛋白阳性	疾病
饥饿性酮症	疾病
大额医疗费用	疾病
劳保医疗	疾病
丧失劳动能力	疾病
企业补充医疗保险	疾病
医疗服务	疾病
肝素	疾病
完全丧失劳动能力	疾病
老年性耳聋	疾病
老年性精神病	疾病
性适应	疾病
血清铁	疾病
物质滥用	疾病
月经紊乱	疾病
基础疾病	疾病
血流停滞	疾病
少年白	疾病
免疫缺陷	疾病
造血功能	疾病
病人角色	疾病
专科护理	疾病
护患关系	疾病
呕吐物吸入	疾病
产妇护理	疾病
甘露四部	疾病
巴氏涂片	疾病
莫干尼	疾病
嗅诊	疾病
白苔	疾病
人畜共患传染病	疾病
精神作用	疾病
三级预防	疾病
流行学	疾病
桡神经	疾病
肱骨内上髁骨折	疾病
桡骨茎突	疾病
肾细胞癌	疾病
pet	疾病
胰岛素敏感性	疾病
内皮祖细胞	疾病
神经根损害	疾病
椎管狭窄	疾病
椎间盘变性	疾病
骨质硬化	疾病
椎间孔	疾病
足下垂	疾病
下肢放射痛	疾病
腿痛	疾病
直腿抬高试验	疾病
马尾神经	疾病
腰椎管狭窄	疾病
侧隐窝	疾病
胸廓畸形	疾病
心肌劳损	疾病
肺动脉段突出	疾病
漏出性出血	疾病
左心室肥大	疾病
向心性肥大	疾病
脉压差	疾病
二尖瓣面容	疾病
类风湿性心脏病	疾病
主动脉炎	疾病
主动脉瓣钙化	疾病
联合瓣膜病	疾病
冻结肩	疾病
继发性骨质疏松症	疾病
腰椎增生	疾病
糖尿病酮症酸中毒	疾病
子宫内膜结核	疾病
肺腺癌	疾病
内在神经	疾病
疮痂病	疾病
子宫腔粘连	疾病
液性暗区	疾病
体位	疾病
多普勒检查	疾病
下肢深静脉血栓形成	疾病
前列腺检查	疾病
强回声	疾病
回盲部	疾病
胎儿生长发育迟缓	疾病
创面修复	疾病
全消化道钡餐	疾病
性功能低下	疾病
间脑综合征	疾病
枕叶肿瘤	疾病
蜗管	疾病
膜迷路	疾病
下肢动脉硬化性闭塞症	疾病
卵巢内胚窦瘤	疾病
肥大细胞	疾病
绒癌	疾病
输卵管良性肿瘤	疾病
恶性滋养细胞肿瘤	疾病
子宫体癌	疾病
伯基特淋巴瘤	疾病
胰岛细胞瘤	疾病
间变性大细胞淋巴瘤	疾病
肾脏肿瘤	疾病
精原细胞瘤	疾病
内胚窦瘤	疾病
淋巴管瘤	疾病
上皮样肉瘤	疾病
肾透明细胞癌	疾病
节细胞神经瘤	疾病
淋巴管肉瘤	疾病
无性细胞瘤	疾病
继发性肿瘤	疾病
瘀证	疾病
β2微球蛋白	疾病
坏疽性脓皮病	疾病
心音图	疾病
动脉瓣	疾病
开瓣音	疾病
骨传导	疾病
心包叩击音	疾病
主动脉缩窄	疾病
第二心音	疾病
三尖瓣狭窄	疾病
性功能减退	疾病
血清免疫球蛋白	疾病
后遗症	疾病
泡性角膜炎	疾病
视网膜血管阻塞	疾病
视神经乳头炎	疾病
老视眼	疾病
眼眶蜂窝织炎	疾病
慢性闭角型青光眼	疾病
黄斑囊样水肿	疾病
致盲	疾病
虹视	疾病
黄斑水肿	疾病
皮肤粗糙	疾病
角膜变性	疾病
手足搐搦性白内障	疾病
绝对期青光眼	疾病
视网膜分支动脉阻塞	疾病
视野缩小	疾病
单眼复视	疾病
眼球穿孔伤	疾病
第二视力	疾病
尿常规红细胞	疾病
非典型性肺炎	疾病
皮质性白内障	疾病
新生血管	疾病
眼睑病变	疾病
黄斑出血	疾病
瞬目反射	疾病
视路病变	疾病
视网膜静脉周围炎	疾病
视网膜静脉阻塞	疾病
角膜基质炎	疾病
中心性浆液性脉络膜视网膜病变	疾病
缺血性视神经病变	疾病
视网膜中央动脉阻塞	疾病
眼睑肿瘤	疾病
视神经病变	疾病
视网膜分支静脉阻塞	疾病
巩膜葡萄肿	疾病
囊下白内障	疾病
核性白内障	疾病
回归热	疾病
眼结石	疾病
孔源性视网膜脱离	疾病
球后视神经炎	疾病
葡萄膜炎	疾病
视网膜动脉阻塞	疾病
低钙性白内障	疾病
视野缺损	疾病
咽肌麻痹	疾病
脊髓丘脑束	疾病
视乳头水肿	疾病
白细胞计数	疾病
迟缓性瘫痪	疾病
巴彬斯基征	疾病
戈登征	疾病
听觉过敏	疾病
奥本海姆征	疾病
蚁行感	疾病
中枢性面瘫	疾病
低血糖休克	疾病
脑干反射	疾病
副伤寒	疾病
保护反射	疾病
缄默症	疾病
心室肥厚	疾病
肥厚型心肌病	疾病
胸膜粘连	疾病
胃泡	疾病
渗出性心包炎	疾病
上腔静脉阻塞综合征	疾病
心包填塞	疾病
新生儿发绀	疾病
耳垂	疾病
青筋	疾病
原发性肺动脉高压	疾病
残疾	疾病
关节置换	疾病
尿崩	疾病
造瘘	疾病
膈肌麻痹	疾病
浊涕	疾病
隐孢子虫	疾病
腹股沟斜疝	疾病
风寒咳嗽	疾病
睾丸肿瘤	疾病
肺包囊虫病	疾病
煤尘肺	疾病
充盈性尿失禁	疾病
安全期避孕	疾病
急性子宫内膜炎	疾病
盆底肌肉	疾病
卵巢炎	疾病
细胞外基质	疾病
压力性尿失禁	疾病
疣状	疾病
尿滴沥	疾病
生殖感染	疾病
外阴炎症	疾病
前列腺肿瘤	疾病
生育年龄	疾病
生殖健康	疾病
自然杀伤细胞	疾病
遗传代谢病	疾病
阴囊肿块	疾病
幼女性外阴阴道炎	疾病
附睾结核	疾病
急性尿潴留	疾病
感染性阴道炎	疾病
急迫性尿失禁	疾病
衣原体病	疾病
氧化应激	疾病
宫颈腺囊肿	疾病
慢性尿道炎	疾病
阴道清洁度	疾病
黄素化	疾病
卵巢巧克力囊肿	疾病
盆腔腹膜炎	疾病
单纯性外阴炎	疾病
逆行射精	疾病
组织修复	疾病
蜜月性阴道炎	疾病
外阴白斑	疾病
急性附睾炎	疾病
滤泡囊肿	疾病
卵巢冠囊肿	疾病
阴茎硬结症	疾病
妇科	疾病
浅反射	疾病
风湿性关节炎	疾病
睾丸支持细胞	疾病
脐带脱垂	疾病
气腹	疾病
搐搦	疾病
血二氧化碳分压	疾病
血管运动中枢	疾病
捻发音	疾病
初步诊断	疾病
沉脉	疾病
滑脉	疾病
直肠指检	疾病
语音共振	疾病
Kernig征	疾病
全身体格检查	疾病
Brudzinski征	疾病
肋脊点	疾病
头风	疾病
体征	疾病
炎症	疾病
热症	疾病
草莓舌	疾病
舌苔薄	疾病
舌苔黄腻	疾病
小儿偏食	疾病
口糜	疾病
剥苔	疾病
舌干	疾病
舌质	疾病
输卵管	疾病
湿热病	疾病
舌色	疾病
胃阴虚	疾病
医疗卫生保健	疾病
肛门指诊	疾病
骨科	疾病
低位直肠癌	疾病
风湿病	疾病
大便带血	疾病
肛管直肠癌	疾病
真虚假实	疾病
腹痛拒按	疾病
阳病	疾病
高原病	疾病
苔润	疾病
下丘脑	疾病
冷汗	疾病
药物疹	疾病
阴虚证	疾病
阴证	疾病
尿清	疾病
虚证	疾病
预防措施	疾病
斑釉	疾病
胸外科	疾病
潜水病	疾病
雄性	疾病
二尖瓣反流	疾病
室壁瘤	疾病
心脏增大	疾病
牙齿磨损	疾病
乳腺钼靶	疾病
乳房超声检查	疾病
衰老	疾病
秋水仙碱	疾病
乳房肿块	疾病
肺实变	疾病
挛缩性疤痕	疾病
蹼状疤痕	疾病
打预防针	疾病
烫火伤	疾病
骨骼发育异常	疾病
蟹足肿	疾病
植皮术	疾病
潮红	疾病
甲型H1N1流感	疾病
蟹足	疾病
烧伤疤痕	疾病
瘢痕癌	疾病
电烧伤	疾病
凸起性疤痕	疾病
平复性疤痕	疾病
浅表性疤痕	疾病
凹陷性疤痕	疾病
眼睑外翻	疾病
疤痕癌	疾病
继发性瘢痕疙瘩	疾病
疤痕手术	疾病
瘴疠之乡	疾病
高温损害	疾病
失用	疾病
鉴别诊断	疾病
不自主运动	疾病
精神官能症	疾病
迟发性运动障碍	疾病
子宫口	疾病
肝病	疾病
撕裂伤	疾病
过期产	疾病
复合先露	疾病
会阴裂伤	疾病
盆腔结缔组织炎	疾病
频尿	疾病
肾钙化	疾病
尿道口红肿	疾病
尿道肿瘤	疾病
泌尿系统结核	疾病
H1N1	病毒
H1N1	疾病
慢性肾盂肾炎	疾病
结核性膀胱炎	疾病
泌尿系结核	疾病
疱疹性口炎	疾病
调节反射	疾病
酮中毒	疾病
危急值	疾病
肾血管疾病	疾病
收缩压	疾病
闭塞性脉管炎	疾病
胸腺	疾病
临终	疾病
经行便血	疾病
免疫性不孕	疾病
血寒	疾病
卵巢周期	疾病
经期过长	疾病
乳房胀痛	疾病
经行吐衄	疾病
年未老经水断	疾病
经行身痛	疾病
森林脑炎	疾病
夜尿多	疾病
无排卵型功能失调性子宫出血	疾病
经断复来	疾病
停经	疾病
促卵泡成熟素	疾病
月经后期	疾病
不排卵	疾病
安全期	疾病
子宫疾病	疾病
急性时相反应蛋白	疾病
脑垂体肿瘤	疾病
继发性闭经	疾病
Meckel憩室	疾病
无锡市第二人民医院	疾病
山西省人民医院	疾病
妇产科	疾病
中国医科大学附属口腔医院	疾病
广东省口腔医院	疾病
山东省千佛山医院	疾病
妊娠线	疾病
河北医科大学第一医院	疾病
河北省儿童医院	疾病
石家庄市中医院	疾病
河北医科大学第四医院	疾病
病理性激情	疾病
发作性睡眠	疾病
早醒	疾病
躁狂发作	疾病
自知力缺乏	疾病
骨髓	疾病
全面性痴呆	疾病
器质性脑病	疾病
脑缺氧	疾病
诱发电位	疾病
症状性精神病	疾病
视幻觉	疾病
运动性幻觉	疾病
触幻觉	疾病
注意障碍	疾病
头部外伤	疾病
毒性	疾病
呼吸窘迫综合征	疾病
妄想性回忆	疾病
自我意识障碍	疾病
味幻觉	疾病
机能性幻听	疾病
随境转移	疾病
部分性痴呆	疾病
抑郁状态	疾病
感觉过敏	疾病
强迫性穷思竭虑	疾病
内脏性幻觉	疾病
纤维化	疾病
逻辑障碍	疾病
联想障碍	疾病
自知力	疾病
木僵	疾病
躯体疾病伴发的精神障碍	疾病
定向力障碍	疾病
违拗症	疾病
酒精中毒性精神障碍	疾病
疑病	疾病
分裂症	疾病
病理检查	疾病
急性意识障碍	疾病
意志障碍	疾病
中毒性脑病	疾病
人格解体	疾病
顺行性遗忘	疾病
焦虑障碍	疾病
时间感知综合障碍	疾病
感觉缺失	疾病
精神衰退	疾病
病理性象征性思维	疾病
纤维粘连蛋白	疾病
内感性不适	疾病
轻躁狂	疾病
被害妄想	疾病
感知综合障碍	疾病
木僵状态	疾病
精神运动性抑制	疾病
梦游症	疾病
逆行性遗忘	疾病
听幻觉	疾病
中山大学附属第二医院	疾病
乳头	疾病
上海市儿童医院	疾病
上海市第一人民医院	疾病
黑龙江省森工总医院	疾病
吉林大学口腔医院	疾病
佳木斯市中心医院	疾病
嘉兴市第一医院	疾病
承德市中心医院	疾病
合肥市第一人民医院	疾病
滨州市人民医院	疾病
胎次	疾病
齐齐哈尔医学院附属第三医院	疾病
大连医科大学附属第二医院	疾病
首都医科大学附属北京安定医院	疾病
鸡西市人民医院	疾病
首都医科大学宣武医院	疾病
佳木斯大学附属第一医院	疾病
嘉兴市第二医院	疾病
合肥市第二人民医院	疾病
济南市中医医院	疾病
辽宁省人民医院	疾病
大脑皮层	疾病
鹤岗市人民医院	疾病
黑龙江省医院	疾病
齐齐哈尔医学院第一附属医院	疾病
安徽省立儿童医院	疾病
产科学	疾病
肾脏病学	疾病
医患沟通	疾病
临床诊断学	疾病
皮肤医学	疾病
人体病理学	疾病
急性时相反应	疾病
首都医科大学附属复兴医院	疾病
造血重建	疾病
心脏损伤	疾病
三期临床	疾病
移植物抗宿主病	疾病
不典型类风湿性关节炎	疾病
关节红肿	疾病
红白血病	疾病
急性再生障碍性贫血	疾病
药物遗传学	疾病
急性失血性贫血	疾病
肥大细胞增多症	疾病
慢性再生障碍性贫血	疾病
类白血病反应	疾病
红血病	疾病
脑移植	疾病
躁狂	疾病
黄体血肿	疾病
皮肤粘膜出血	疾病
脉络丛乳头状瘤	疾病
血管性血友病	疾病
脊肌萎缩症	疾病
枕大池	疾病
脑缺血性疾病	疾病
脑血管瘤	疾病
线粒体脑肌病	疾病
Rett综合征	疾病
瘢痕体质	疾病
肾淀粉样变性	疾病
Ⅳ型超敏反应	疾病
肉芽组织	疾病
狼疮带试验	疾病
尿C肽测定	疾病
心肌酶	疾病
脑囊肿	疾病
药物滥用	疾病
进行性脊肌萎缩	疾病
吞咽运动	疾病
眼球缺失	疾病
限制型心肌病	疾病
狼疮肾炎	疾病
玻璃体出血	疾病
ICD-10	疾病
脊髓缺血	疾病
脑梗塞后遗症	疾病
甲泼尼龙	疾病
颈纹	疾病
肝穿刺	疾病
急性特发性多神经炎	疾病
粘液样变性	疾病
炎细胞浸润	疾病
B细胞杂交瘤	疾病
肉芽肿性血管炎	疾病
原发性肾小球肾炎	疾病
纤维素样变性	疾病
胶原病	疾病
原发性胆汁性肝硬变	疾病
血液疾病	疾病
交感神经兴奋性	疾病
涎腺	疾病
转移性恶性肿瘤	疾病
羊膜干细胞	疾病
酸中毒	疾病
肝脏疾病	疾病
外周血干细胞移植	疾病
股骨头塌陷	疾病
下肢动脉硬化	疾病
股骨头	疾病
腰疼	疾病
气分证	疾病
外感热病	疾病
水肿病	疾病
伤阴	疾病
尿激酶	疾病
营分证	疾病
阴厥	疾病
郁证	疾病
脉滑	疾病
病机十九条	疾病
内风	疾病
清代名医医案精华	疾病
中焦虚寒证	疾病
肝热	疾病
内伤头痛	疾病
催乳素	疾病
外感头痛	疾病
肾气盛	疾病
邪气盛则实	疾病
颠疾	疾病
痛觉反射	疾病
产后休养	疾病
急产	疾病
横位	疾病
吴门医派	疾病
风火牙痛	疾病
深龋	疾病
牙宣	疾病
牙外伤	疾病
骨槽风	疾病
颌骨囊肿	疾病
气血	疾病
熏灸	疾病
α1-酸性糖蛋白	疾病
温和灸	疾病
隔饼灸	疾病
行气活血	疾病
痈疽	疾病
霍乱转筋	疾病
灸疗	疾病
阳虚体质	疾病
厥逆	疾病
泻肝	疾病
肺叶	疾病
卵巢	疾病
脑转	疾病
肝主疏泄	疾病
胁下痛	疾病
通腑泄热	疾病
热入心包	疾病
温邪犯肺	疾病
固泄	疾病
心中憺憺大动	疾病
顺传	疾病
组织因子	疾病
下膈	疾病
目痛	疾病
寒湿痢	疾病
阴虚发热	疾病
久痢	疾病
湿热痢	疾病
微者逆之	疾病
正虚邪实	疾病
甚者从之	疾病
通因通用	疾病
疗效	疾病
间脑	疾病
衰者补之	疾病
标本缓急	疾病
治病求本	疾病
虚则补之	疾病
中气下陷	疾病
反治	疾病
温者清之	疾病
肺失肃降	疾病
厥阴病	疾病
太阴病	疾病
炎症反应	疾病
少阳病	疾病
太阳病	疾病
少阴病	疾病
阳明病	疾病
金匮要略方论本义	疾病
气痞	疾病
善饥	疾病
颈肿	疾病
衄血	疾病
急性期反应蛋白	疾病
喉痹	疾病
心下满	疾病
痛痹	疾病
十四经穴	疾病
癖气	疾病
噫气	疾病
里证	疾病
五志化火	疾病
风痰	疾病
亡阳	疾病
温病气分证	疾病
温补	疾病
薛己	疾病
病因学说	疾病
温热论	疾病
新感温病	疾病
暑病	疾病
热性病	疾病
广温疫论	疾病
脊髓	疾病
风温	疾病
治上焦如羽	疾病
大头瘟	疾病
温毒	疾病
临证指南医案	疾病
乙肝转阴	疾病
丹痧	疾病
外感病因	疾病
血分	疾病
阳证	疾病
孕激素	疾病
太阳经病	疾病
三阴病	疾病
三焦病证	疾病
太阳腑证	疾病
脉象滑	疾病
厥阴病证	疾病
少阳病证	疾病
手太阴肺经病	疾病
心血虚	疾病
三阳病	疾病
胸胁满	疾病
小中	疾病
热邪壅肺	疾病
脘腹	疾病
胸闷气短	疾病
血虚证	疾病
切诊	疾病
血热证	疾病
精神调养	疾病
气道炎症	疾病
血淤体质	疾病
性味	疾病
逆传心包	疾病
秋温	疾病
新感	疾病
温邪	疾病
蓄血	疾病
通瘀破结	疾病
雌激素	疾病
戾气	疾病
通下	疾病
湿阻中焦	疾病
阴阳交	疾病
卫气同病	疾病
伏邪温病	疾病
冬温	疾病
三焦病	疾病
纯阳之体	疾病
虚泻	疾病
雌性激素	疾病
片玉心书	疾病
小儿痘疹方论	疾病
痿病	疾病
肠胃疾病	疾病
色诊	疾病
新生儿病	疾病
疳证	疾病
儿童多动综合征	疾病
形气	疾病
儿科病	疾病
白喉	细菌
白喉	疾病
呼吸系统疾病	疾病
济婴撮要	疾病
脾常不足	疾病
奶麻	疾病
痿证	疾病
顿咳	疾病
后囟	疾病
汗证	疾病
脐湿	疾病
活幼口议	疾病
小儿脉法	疾病
α2-巨球蛋白	疾病
燥邪	疾病
脐部疾患	疾病
肾常虚	疾病
变蒸学说	疾病
小儿暑温	疾病
小头畸形	疾病
赤游丹	疾病
小儿医	疾病
寒泻	疾病
坐骨神经	疾病
脏腑的寒热虚实	疾病
紫癜风	疾病
疰夏	疾病
体禀纯阳	疾病
惊风	疾病
胎怯	疾病
鼻渊	疾病
活幼心书	疾病
逆证	疾病
心常有余	疾病
猪捷申病	疾病
湿阻	疾病
前囟	疾病
稚阴稚阳	疾病
胃气不和	疾病
痞满	疾病
中气下陷证	疾病
微脉	疾病
问起病	疾病
走窜痛	疾病
视上核	疾病
空痛	疾病
循衣摸床	疾病
形寒肢冷	疾病
弱脉	疾病
脾胃虚	疾病
心主舌	疾病
水饮内停	疾病
涩脉	疾病
代脉	疾病
单核吞噬细胞系统	疾病
喜按	疾病
赫依	疾病
酸马奶疗法	疾病
尚论篇	疾病
脾湿	疾病
大汗出	疾病
花剥苔	疾病
肛门肿痛	疾病
心火上炎	疾病
实火	疾病
内分泌系统	疾病
纹沉	疾病
舌态	疾病
血府	疾病
问耳目	疾病
久聋	疾病
脾不统血	疾病
问大小便	疾病
口咸	疾病
中风先兆	疾病
小便闭	疾病
急性出血性结膜炎	疾病
纹浮	疾病
外荣	疾病
心火亢盛	疾病
月经先后无定期	疾病
望指纹	疾病
上工治未病	疾病
七日节律	疾病
疙瘩瘟	疾病
养阴生津	疾病
瓜瓤瘟	疾病
念珠状	疾病
舍脉从症	疾病
木克土	疾病
身热	疾病
开牙合畸形	疾病
二阴	疾病
瘰疬	疾病
髌骨劳损	疾病
项背筋膜炎	疾病
肩峰下滑囊炎	疾病
眉棱骨痛	疾病
丙型肝炎抗体	疾病
远伤病	疾病
肱骨内上髁炎	疾病
肌筋膜炎	疾病
肱骨外上髁炎	疾病
慢性盆腔疼痛	疾病
冈上肌肌腱炎	疾病
悬命	疾病
慢性腰肌劳损	疾病
低钙血症	疾病
病机学说	疾病
医医病书	疾病
徐疾补泻	疾病
温针灸	疾病
夹脊穴	疾病
特异体质	疾病
平和体质	疾病
肌肤甲错	疾病
实性体质	疾病
阴虚质	疾病
乙肝表面抗原	疾病
湿热体质	疾病
瘀血体质	疾病
行气	疾病
虚性体质	疾病
阳虚质	疾病
补血	疾病
中药炮制	疾病
泻痢	疾病
阴病	疾病
泻有余	疾病
乳腺肿瘤	疾病
舍证从脉	疾病
舍脉从证	疾病
脉象主病	疾病
二十八脉	疾病
脉沉	疾病
缓脉	疾病
散脉	疾病
下利清谷	疾病
温里	疾病
气血津液病证	疾病
遗传缺陷	疾病
六经病	疾病
眉寿堂方案选存	疾病
主证	疾病
温邪上受	疾病
疑难杂病	疾病
诊脉	疾病
医效秘传	疾病
脉痹	疾病
润下	疾病
心阴	疾病
手口足病	疾病
取类比象	疾病
脉数	疾病
心气通于舌	疾病
内损	疾病
疮疡经验全书	疾病
外科证治全书	疾病
外科枢要	疾病
外寒	疾病
湿病	疾病
内湿	疾病
外周神经损伤	疾病
火证	疾病
暴热	疾病
热淫	疾病
热极生风	疾病
寒疾	疾病
火性炎上	疾病
暑邪	疾病
内燥	疾病
湿淫	疾病
燥易伤肺	疾病
心律失常	疾病
风证	疾病
巨乳症	疾病
月经病	疾病
症瘕	疾病
金匮钩玄	疾病
痰证	疾病
热痰	疾病
相火妄动	疾病
尪痹	疾病
症候	疾病
中脑	疾病
血块	疾病
血不归经	疾病
清窍	疾病
情志内伤	疾病
气滞	疾病
肝气郁滞	疾病
气少	疾病
气机不利	疾病
气虚血瘀证	疾病
饮食失调症	疾病
水禽	疾病
吸烟上瘾	疾病
光化性角化病	疾病
温中祛寒	疾病
失精	疾病
虚热证	疾病
正邪相争	疾病
病因辨证	疾病
血虚咳嗽	疾病
表里双解	疾病
持续性感染	疾病
气虚咳嗽	疾病
清热解暑	疾病
寒症	疾病
退烧	疾病
胃实	疾病
傅青主男科	疾病
气机郁滞	疾病
脏腑病机	疾病
霍乱	疾病
细支气管炎	疾病
阴阳格拒	疾病
肝胃不和	疾病
七情内伤	疾病
情志病	疾病
虚邪	疾病
痰浊头痛	疾病
肝气犯胃	疾病
五邪	疾病
肝肾阴虚	疾病
乳房	疾病
寒热辨证	疾病
失眠病	疾病
循经取穴	疾病
肝火上炎	疾病
病候	疾病
瘀血头痛	疾病
太阳阳明合病	疾病
下痞	疾病
温法	疾病
热厥	疾病
法氏囊病	疾病
并病	疾病
阴虚阳亢	疾病
合病	疾病
胃家实	疾病
蓄水证	疾病
虚寒证	疾病
蓄血证	疾病
吐涎沫	疾病
循经传	疾病
胸胁苦满	疾病
传染性法氏囊病	疾病
厥热胜复	疾病
小便黄赤	疾病
上热下寒证	疾病
热结下焦	疾病
肢节烦痛	疾病
项背强几几	疾病
寒热错杂证	疾病
吐蛔	疾病
大便不通	疾病
泄痢	疾病
西班牙女士	病毒
西班牙女士	疾病
心下悸	疾病
表里俱热	疾病
心动悸	疾病
太阳中风	疾病
干呕	疾病
尘螨过敏性哮喘	疾病
古今医鉴	疾病
婴幼儿哮喘	疾病
痈疮	疾病
先天	疾病
水疱	疾病
下气	疾病
马兜铃酸	疾病
药物治疗	疾病
宣肺止咳	疾病
武火	疾病
治病	疾病
鸡肝汤	疾病
五淋	疾病
寒痰	疾病
溺血	疾病
人类遗传病	疾病
皮下出血点	疾病
胸胁支满	疾病
月经提前	疾病
湿症	疾病
潜伏感染	病毒
潜伏感染	疾病
艾滋病核酸检测	疾病
手脚麻木	疾病
糖化血红蛋白	疾病
基础胰岛素	疾病
浆细胞瘤	疾病
疾病管理	疾病
牙齿外突	疾病
腺样体面容	疾病
扁桃体肥大	疾病
外热	疾病
阳胜则阴病	疾病
阴胜则阳病	疾病
阳盛格阴	疾病
肾损伤	疾病
急性胃十二指肠溃疡穿孔	疾病
肾、输尿管结石	疾病
腹膜后血肿	疾病
骨折愈合	疾病
螺旋形骨折	疾病
捺正	疾病
盘状红斑狼疮	疾病
夜尿症	疾病
艾炷灸	疾病
皮部	疾病
成人痘	疾病
高血钾	疾病
弯针	疾病
折针	疾病
脊髓灰质炎后遗症	疾病
胃胀气	疾病
丛针	疾病
隔姜灸	疾病
锋勾针	疾病
软组织挫伤	疾病
肌性斜颈	疾病
结核性关节炎	疾病
高钾血症	疾病
厥症	疾病
腰椎后关节紊乱症	疾病
尸厥	疾病
颜面神经麻痹	疾病
厌食	疾病
乳痈	疾病
外治法	疾病
肩关节周围炎	疾病
物理疗法	疾病
闭合性软组织损伤	疾病
激素反应元件	疾病
股神经痛	疾病
脊髓型颈椎病	疾病
痿症	疾病
通脉	疾病
通淋	疾病
奇穴	疾病
心痹	疾病
小肠病	疾病
头针疗法	疾病
熄风	疾病
蛋白电泳	疾病
疾因	疾病
固涩药	疾病
痫证	疾病
理气	疾病
大肠病	疾病
功能性低血糖	疾病
植物神经紊乱症	疾病
濒死感	疾病
植物神经失调症	疾病
神经回路学说	疾病
原养型	疾病
情绪症状	疾病
晚育	疾病
优生	疾病
育龄妇女	疾病
挑食	疾病
人工关节置换术	疾病
风湿免疫病学	疾病
职业卫生技术服务	疾病
法定报告传染病	疾病
心搏骤停	疾病
阴道	疾病
心肌供血不足	疾病
性交猝死	疾病
意外怀孕	疾病
性欲高潮功能障碍	疾病
阴吹	疾病
盆腔炎症	疾病
小产	疾病
逆行感染	疾病
电子病历	疾病
韶关市第一人民医院	疾病
纤维蛋白溶解系统	疾病
妊娠滋养细胞疾病	疾病
卵泡监测	疾病
免疫性不育	疾病
优势卵泡	疾病
射精障碍	疾病
弱精子症	疾病
医疗风险	疾病
卵子赠送	疾病
病态窦房结综合症	疾病
食管破裂	疾病
基因移植	疾病
肠壁坏死	疾病
尿三胆	疾病
食管贲门失驰缓症	疾病
肝功能试验	疾病
坏疽	疾病
硬化性胆管炎	疾病
运动性疾病	疾病
肝穿刺活组织检查	疾病
人绒毛膜促性腺激素	疾病
机械性肠梗阻	疾病
隐血试验	疾病
输卵管卵巢脓肿	疾病
输卵管妊娠	疾病
腺垂体激素	疾病
醛固醇	疾病
APUD	疾病
脑肠肽	疾病
黄素囊肿	疾病
肾周围脓肿	疾病
尿道感染	疾病
脐尿管囊肿	疾病
胎儿宫内窘迫	疾病
腹泻便血	疾病
盲肠癌	疾病
肠系膜淋巴结结核	疾病
肾盂积水	疾病
卵巢肿瘤破裂	疾病
输卵管吻合	疾病
阴道平滑肌肉瘤	疾病
丘疹性银屑病	疾病
呼吸道感染	疾病
阴道鳞状上皮癌	疾病
阴道腺癌	疾病
原发性阴道鳞癌	疾病
乳头瘤	疾病
过敏皮炎	疾病
性交障碍	疾病
平滑肌瘤	疾病
造口	疾病
菜花状	疾病
同时感染	疾病
尿道	疾病
神经瘤	疾病
外阴痛	疾病
肠闭锁	疾病
阴道良性肿瘤	疾病
肠鸣音亢进	疾病
阴道恶性肿瘤	疾病
低位肠梗阻	疾病
单纯性肠梗阻	疾病
先天性代谢病	疾病
胎心率	疾病
脑水肿	疾病
肾发育不全	疾病
幽门狭窄	疾病
羊水细胞	疾病
高危妊娠	疾病
胎儿成熟度	疾病
医学决定水平	疾病
腹裂	疾病
遗传咨询师	疾病
宫颈浸润癌	疾病
实验动物	疾病
下丘脑错构瘤	疾病
睾丸缺如	疾病
卵巢冠	疾病
男性功能障碍	疾病
卵巢妊娠	疾病
喉乳头状瘤	疾病
子宫收缩乏力	疾病
尿瘘	疾病
子宫平滑肌肉瘤	疾病
单基因病	疾病
晨勃	疾病
性幻想	疾病
负情绪	疾病
雄性荷尔蒙	疾病
浆膜下肌瘤	疾病
非赘生性囊肿	疾病
胎盘滞留	疾病
阴肿	疾病
阴痒	疾病
肝郁脾虚	疾病
转氨酶	疾病
阴痛	疾病
阴蚀	疾病
阵发性心动过速	疾病
自身溶血试验	疾病
马尔芬氏综合征	疾病
息肉恶变	疾病
延迟显性	疾病
脾窦	疾病
异常血红蛋白病	疾病
遗传病基因	疾病
呼吸道	疾病
经效产宝	疾病
宫内诊断	疾病
疾病易感基因	疾病
13三体综合征	疾病
18三体综合征	疾病
脆性X	疾病
血清甲胎蛋白	疾病
染色体异常遗传病	疾病
先天性代谢异常	疾病
胱氨酸尿症	疾病
肝癌	疾病
尿黑酸尿症	疾病
戊糖尿症	疾病
遗传性酪氨酸血症	疾病
杜氏肌营养不良	疾病
智力残疾	疾病
脊髓性肌萎缩症	疾病
男性假两性畸形	疾病
蹼颈	疾病
语言障碍	疾病
缺陷基因	疾病
阴茎短小	疾病
耳廓畸形	疾病
断掌	疾病
Edward综合征	疾病
招风耳	疾病
女性假两性畸形	疾病
真两性畸形	疾病
性染色体病	疾病
常染色体病	疾病
抗血友病因子	疾病
CYP3A	疾病
苯巴比妥中毒	疾病
Burkitt淋巴瘤	疾病
男性乳腺癌	疾病
家族性结肠息肉病	疾病
短指症	疾病
病理性骨折	疾病
溶酶体贮积症	疾病
糖原贮积症	疾病
恶性脑胶质瘤	疾病
活动受限	疾病
断续性呼吸音	疾病
肺泡呼吸音	疾病
管样呼吸音	疾病
空洞型肺结核	疾病
胸骨后疼痛	疾病
扣诊	疾病
胸壁皮下气肿	疾病
二尖瓣环钙化	疾病
食管损伤	疾病
慢性气管炎	疾病
化疗药物	疾病
胸部损伤	疾病
眼眶炎症	疾病
眼眶外伤	疾病
血流信号	疾病
气管支气管狭窄	疾病
鼻咽部纤维血管瘤	疾病
脑白质病	疾病
半月板损伤	疾病
滑液	疾病
托马斯·艾迪生	疾病
车祸伤	疾病
肩部骨折	疾病
语言发育障碍	疾病
性欲异常	疾病
男性性功能障碍	疾病
性厌恶	疾病
阴茎勃起障碍	疾病
康复	疾病
痔核	疾病
低密度脂蛋白	疾病
下肢静脉血栓形成	疾病
沉箱病	疾病
降主动脉动脉瘤	疾病
主动脉口狭窄	疾病
下肢静脉淤积性溃疡	疾病
扁桃体癌	疾病
盆腔肿瘤	疾病
射频消融	疾病
颌面部肿瘤	疾病
单基因遗传病	疾病
盆底腹膜疝	疾病
先天性胸腹裂孔疝	疾病
腹股沟滑动疝	疾病
肺疝	疾病
创伤性膈疝	疾病
复发性腹股沟疝	疾病
小儿先天性膈疝	疾病
腹外疝	疾病
嵌顿性腹股沟斜疝	疾病
十二指肠旁疝	疾病
动物模型	疾病
婴儿痉挛症	疾病
脑囊虫病	疾病
小儿高热惊厥	疾病
新生儿脱水热	疾病
依从性	疾病
谷氨酰转肽酶	疾病
血液系统疾病	疾病
奈韦拉平	疾病
关节疾病	疾病
放射病	疾病
中毒性肾病	疾病
脉络宁注射液	疾病
特发性腹膜后纤维化	疾病
谵语	疾病
痛风性肾病	疾病
尿毒症性心包炎	疾病
膜增殖性肾小球肾炎	疾病
果糖代谢	疾病
肾脏纤维化	疾病
肾乳头坏死	疾病
终末期肾病	疾病
梗阻性肾病	疾病
痰	疾病
心因性疾病	疾病
细支气管肺泡癌	疾病
炎性假瘤	疾病
眼球内陷	疾病
咽喉病	疾病
甲剥离症	疾病
下焦湿热	疾病
卵巢巧克力囊肿破裂	疾病
精少	疾病
胆病	疾病
斜飞脉	疾病
脉诊仪	疾病
中医病名诊断规范初稿	疾病
虚胀	疾病
人体胚胎	疾病
危急重症	疾病
注下	疾病
少腹拘急	疾病
小便赤涩	疾病
热迫大肠	疾病
湿泻	疾病
泄注	疾病
下迫	疾病
寝汗	疾病
联合瓣膜病变	疾病
子宫	疾病
发汗	疾病
出血性血小板增多症	疾病
无汗	疾病
敛汗	疾病
小儿盗汗	疾病
束臂试验	疾病
血管性紫癜	疾病
慢性胰腺炎	疾病
眼睑浮肿	疾病
乙型流感	疾病
重症联合免疫缺陷	疾病
养血	疾病
往来寒热	疾病
微热	疾病
血虚发热	疾病
伤食	疾病
痰浊内闭	疾病
子盗母气	疾病
玄府	疾病
太阴伏暑	疾病
温燥	疾病
细胞再生	疾病
百合病	疾病
酸枣核	疾病
内伤发热	疾病
褐斑	疾病
小儿结核病	疾病
憩室病	疾病
宿便	疾病
肛肠	疾病
忧郁	疾病
痰火扰心	疾病
气癃	疾病
尿等待	疾病
惊疳	疾病
经期保健	疾病
舌淡	疾病
持续腹泻	疾病
间质性膀胱炎	疾病
肝肿瘤	疾病
心律不齐	疾病
神经性尿频	疾病
脾虚泄泻	疾病
吐蚘	疾病
舌卷囊缩	疾病
小儿肝炎	疾病
阴热	疾病
早秃	疾病
心窝部	疾病
输血后肝炎	疾病
化妆品过敏	疾病
白汗	疾病
心下痛	疾病
肝活检	疾病
肾阳	疾病
急性黄色肝萎缩	疾病
小便涩痛	疾病
血淋	疾病
四逆	疾病
手足逆冷	疾病
劳淋	疾病
维生素A	疾病
失气	疾病
特异度	疾病
仆击	疾病
月经早熟症	疾病
外阴瘙痒症	疾病
甲状腺毒症	疾病
射精延迟	疾病
溃疡膜性咽峡炎	疾病
痉挛	疾病
咽后脓肿	疾病
咽结核	疾病
急性舌扁桃体炎	疾病
舌咽神经痛	疾病
疱疹性咽炎	疾病
急性会厌炎	疾病
听觉传导通路	疾病
前庭功能检查	疾病
外伤性眩晕	疾病
生殖系统	疾病
听神经病	疾病
眼源性眩晕	疾病
周围性眩晕	疾病
中枢性眩晕	疾病
血压性眩晕	疾病
鼓膜炎	疾病
蛊胀	疾病
椎-基底动脉供血不足	疾病
眩晕症	疾病
胃损伤	疾病
胸中烦热	疾病
虚热	疾病
疟疾病	疾病
小儿夏季热	疾病
湿温病	疾病
腹冷痛	疾病
胁肋胀痛	疾病
热结膀胱	疾病
少腹急结	疾病
行瘀	疾病
外阴	疾病
泄精	疾病
频繁遗精	疾病
锐痛	疾病
急性输卵管卵巢炎	疾病
卵巢黄体破裂	疾病
宫颈管粘连	疾病
胃脘痛	疾病
盆腔淤血症	疾病
剖腹探查术	疾病
输卵管不通	疾病
烦热	疾病
手心热	疾病
暴食症	疾病
新陈代谢紊乱	疾病
小便数	疾病
下消	疾病
痟中	疾病
消浊	疾病
富贵病	疾病
三消	疾病
枝原体目	细菌
枝原体目	疾病
消中	疾病
喜气	疾病
眼疾	疾病
失血性贫血	疾病
气血两虚证	疾病
妊娠合并子宫肌瘤	疾病
植入性胎盘	疾病
胎盘植入	疾病
饮食紊乱	疾病
B型超声波检查	疾病
褪黑激素	疾病
第一产程	疾病
子宫收缩力	疾病
子宫内翻	疾病
子宫乏力	疾病
宫缩乏力	疾病
副胎盘	疾病
阴虚血热证	疾病
二十三蒸	疾病
五蒸	疾病
慢性纤维空洞型肺结核	疾病
生理性消化不良	疾病
齿黑	疾病
白色瘟疫	疾病
流口水	疾病
牙齿畸形	疾病
睡觉姿势	疾病
系络	疾病
头项软	疾病
清暑益气	疾病
慢性喘息性支气管炎	疾病
胖大舌	疾病
消化道	疾病
齿痕舌	疾病
杂病	疾病
脾阳不振	疾病
红绛舌	疾病
苔滑	疾病
湿热症	疾病
中诊	疾病
吐弄舌	疾病
舌短	疾病
咬合创伤	疾病
颅骨	疾病
寒结	疾病
湿中	疾病
伤元气	疾病
囟开不合	疾病
口噤	疾病
赤白带下	疾病
目系	疾病
胸胁痛	疾病
漏斗胸	疾病
膝关	疾病
血培养	疾病
内踝上	疾病
阳强	疾病
有神	疾病
强迫体位	疾病
阴茎痛	疾病
畸形牙	疾病
手足躁扰	疾病
癫病	疾病
深覆牙合	疾病
躁狂抑郁症	疾病
呕吐中枢	疾病
青少年牙周炎	疾病
天柱骨倒	疾病
性紧张	疾病
颧赤	疾病
寒湿困脾证	疾病
上胞下垂	疾病
牙周萎缩	疾病
夏应中矩	疾病
脾阳虚证	疾病
上焦火	疾病
平滑肌痉挛	疾病
脾虚胃寒	疾病
外膝眼	疾病
外踝尖	疾病
外陵	疾病
口僻	疾病
跗肿	疾病
额颅	疾病
胃足阳明之脉	疾病
血浆凝固酶	疾病
下乳	疾病
肌腱膜	疾病
膝外	疾病
陷骨	疾病
瞳神病	疾病
黄仁	疾病
发冷	疾病
热深厥深	疾病
囊缩	疾病
预后良好	疾病
寒中	疾病
高位肛瘘	疾病
肛肠病	疾病
脾寒	疾病
小儿遗尿	疾病
推拿疗法	疾病
卡他性口炎	疾病
内八卦	疾病
五官	疾病
痰火	疾病
红皮病	疾病
软骨炎	疾病
平衡针灸	疾病
传尸	疾病
沁心源超浓缩矿元素	疾病
环状胰腺	疾病
新生儿	疾病
先天性肠旋转不良	疾病
尿道上裂	疾病
膀胱输尿管返流	疾病
右室双出口	疾病
小儿鼾症	疾病
小儿先天性胆管扩张症	疾病
肺动脉闭锁	疾病
小儿普外科	疾病
脐膨出	疾病
骨不连	疾病
结瘤	疾病
肿块	疾病
动脉疾病	疾病
乳癖	疾病
医疗差错	疾病
假性动脉瘤	疾病
焦郁碌	疾病
科赫氏法则	疾病
雷诺病	疾病
妄想症	疾病
人格障碍	疾病
反社会型人格障碍	疾病
体弱儿	疾病
5岁以下儿童死亡率	疾病
免疫功能低下	疾病
性感带	疾病
理性情绪疗法	疾病
下颌关节脱位	疾病
肱骨外髁骨折	疾病
艾柱	疾病
胸腰椎骨折	疾病
骨病	疾病
化脓性炎	疾病
侵袭力	疾病
腕舟骨骨折	疾病
类脂质沉积症	疾病
股骨髁上骨折	疾病
踝关节骨折	疾病
掌骨骨折	疾病
恶性骨肿瘤	疾病
桡骨干骨折	疾病
胸锁关节脱位	疾病
肌蛋白	疾病
颈椎骨折	疾病
跖趾关节脱位	疾病
跖骨骨折	疾病
膝关节脱位	疾病
骨质软化症	疾病
骨扫描	疾病
练功疗法	疾病
尺骨干骨折	疾病
胫骨髁骨折	疾病
低密度脂蛋白胆固醇	疾病
指骨骨折	疾病
水针疗法	疾病
踝关节脱位	疾病
距骨骨折	疾病
指间关节脱位	疾病
尺骨鹰嘴骨折	疾病
开放性骨折	疾病
尺骨上1/3骨折合并桡骨头脱位	疾病
胆汁酸	疾病
骨折畸形愈合	疾病
桡骨下端骨折	疾病
血友病性关节炎	疾病
肱骨髁间骨折	疾病
股骨髁部骨折	疾病
护理程序	疾病
静脉血压	疾病
下丘脑激素	疾病
马流行性感冒	疾病
阿尔维德·卡尔松	疾病
痰热壅肺证	疾病
肺肾阴虚证	疾病
环磷鸟苷	疾病
家畜寄生虫病	疾病
泌尿器	疾病
急性出血性胰腺炎	疾病
新孢子虫病	疾病
隐孢子虫病	疾病
虫卵肉芽肿	疾病
肠道传染病	疾病
巴贝虫病	疾病
棘球蚴病	疾病
中华白蛉	疾病
棘球蚴	疾病
猫圆线虫病	疾病
利什曼原虫病	疾病
钩虫卵	疾病
热带病	疾病
囊尾蚴病	疾病
慢性阿米巴痢疾	疾病
猪囊虫病	疾病
未来医学	疾病
通气/血流比值	疾病
肝脂肪变性	疾病
上海市中西医结合医院	疾病
上海市第七人民医院	疾病
皮脂腺癌	疾病
结核疹	疾病
珍珠状阴茎丘疹	疾病
红斑增生病	疾病
精子无力症	疾病
无嗣	疾病
男子不育	疾病
绝对不育	疾病
相对不育	疾病
睾丸肿胀	疾病
输精管道梗阻	疾病
醛固酮增多症	疾病
亚麻酸	疾病
精液异常症	疾病
隐匿阴茎	疾病
叫床	疾病
中心静脉压	疾病
阴茎纤维性海绵体炎	疾病
阴茎扭转	疾病
阴茎结核	疾病
阴茎阴囊转位	疾病
下疳	疾病
万寿菊叶黄素	疾病
假性包皮过长	疾病
精神性阳痿	疾病
广肠	疾病
北京地坛医院	疾病
胆道出血	疾病
弹性假黄瘤	疾病
FSH	疾病
prl	疾病
四日市哮喘	疾病
转移性右下腹痛	疾病
肠道疾病	疾病
营养病分布	疾病
皮肤感染	疾病
中毒性痢疾	疾病
小儿骨折	疾病
职业病危害	疾病
传染病流行病学	疾病
队列研究	疾病
渥太华宪章	疾病
肌炎	疾病
急性风湿性关节炎	疾病
生殖	疾病
鲜红斑痣	疾病
骨软骨病	疾病
黄斑病变	疾病
潜在减寿年数	疾病
伤残调整寿命年	疾病
临床死亡期	疾病
病理性死亡	疾病
胃癌前病变	疾病
亡阴	疾病
自然衰老	疾病
驱虫	疾病
代偿反应	疾病
营养缺乏病	疾病
营养不良性水肿	疾病
推荐膳食供给量	疾病
NCD	疾病
自体瓣膜心内膜炎	疾病
实验性精神病	疾病
疥癣病	疾病
家族性结肠腺瘤伴多发肿瘤综合征	疾病
玻璃晶体浑浊	疾病
硬化	疾病
微笑型抑郁症	疾病
菜豆炭腐病	病毒
赤衣病	病毒
艾氏小杆线虫病	疾病
肛癣	疾病
慢性铅中毒	疾病
晕动症	疾病
获得性面部皮肤衰老症	疾病
幼年类风湿性关节炎	疾病
葡萄轮斑病	病毒
传染病	病毒
传染病	疾病
库鲁病	疾病
偏头痛	疾病
笋瓜蔓枯病	病毒
成人全垂体功能减退	疾病
原发性心肌病	疾病
膈扑动	疾病
急性肾炎综合征	疾病
苹果轮斑病	病毒
H3N2	病毒
H3N2	疾病
棘头虫病	疾病
老年性根龋	疾病
锥虫	疾病
股动脉假性动脉瘤	疾病
嫁接黄瓜根腐病	病毒
番茄青霉果腐病	病毒
血丝虫病	疾病
母源病	疾病
宠物依赖症	疾病
选择性缄默失调症	疾病
亚疾病	疾病
间质性肺炎	疾病
旋耳疮	疾病
癫痫	疾病
果汁综合症	疾病
三叉神经瘤	疾病
法洛三联症	疾病
室上速	疾病
非特异性外阴炎	疾病
甜菜立枯病	病毒
纤维肌痛症	疾病
维生素C缺乏病	疾病
粘连	疾病
原发性骨髓纤维化	疾病
肺泡细胞癌	疾病
米勒费雪症候群	疾病
婴儿肝炎	疾病
疫疔	疾病
檫树溃疡病	疾病
尼帕病毒	疾病
过敏性湿疹	疾病
脂膜炎	疾病
宇宙综合症	疾病
中毒性高铁血红蛋白血症	疾病
豇豆菌核病	病毒
掉下巴	疾病
聚乙二醇过敏症	疾病
小麦条纹花叶病	病毒
心劳	疾病
闭锁综合症	疾病
牙髓息肉	疾病
石瘿	疾病
梨青霉病	病毒
支气管肺发育不良	疾病
下颌关节复位	疾病
猪应激综合症	疾病
巴特综合征	疾病
特发性含铁血黄素沉着症	疾病
电邮综合症	疾病
蛔虫卵	疾病
蚕豆黄萎病	病毒
老年心力衰竭	疾病
向日葵锈病	病毒
肠外原虫	疾病
急性丁型肝炎	疾病
内分泌病	疾病
急性风湿病	疾病
膀胱瘘	疾病
甜菜霜霉病	病毒
低血糖综合症	疾病
细胞间识别	疾病
中心性视网膜炎	疾病
鼠疮	疾病
柑橘赤衣病	病毒
马查多-约瑟夫病	疾病
大头症	疾病
小儿结节病	疾病
支原体性感染症	疾病
鲤春病毒病	病毒
鲤春病毒病	疾病
缺血性挛缩	疾病
物理致癌因子	疾病
乙肝肾炎	疾病
阿卡斑病	疾病
猪乙型脑炎	疾病
小儿脑炎	疾病
白菜类黑胫病	病毒
血红蛋白C病	疾病
虫咬性皮炎	疾病
间动电疗法	疾病
人格解体神经症	疾病
非结核分枝杆菌肺病	疾病
龙胆紫溶液	疾病
牛传染性鼻气管炎	疾病
谷氨酸单钠症候群	疾病
中枢神经系统白血病	疾病
猪肺丝虫病	疾病
风湿性脊柱炎	疾病
息肉痔	疾病
白菜类幼苗立枯病	病毒
纤维蛋白性心包炎	疾病
营养性维生素D缺乏性手足抽搐症	疾病
肠绦虫病	疾病
克雅氏病	疾病
肾上腺皮质	疾病
桑污叶病	病毒
鸡绦虫病	疾病
乌塌菜菌核病	病毒
冬瓜黑斑病	病毒
链球菌感染后的急性肾小球肾炎	疾病
慢性阻塞性系统疾病	疾病
糖尿病白内障	疾病
网状青斑症	疾病
甜菜蛇眼病	病毒
类固醇	疾病
外阴鳞状细胞癌	疾病
肉瘿	疾病
斯特格病	疾病
犬外耳炎	病毒
犬外耳炎	疾病
真菌性心内膜炎	疾病
异位肾	疾病
乡愁综合症	疾病
南瓜灰斑病	病毒
梨煤污病	病毒
细胞的癌变	疾病
肺动脉口狭窄	疾病
甜菜褐斑病	病毒
成人多动症	疾病
远端型肾小管酸中毒	疾病
喉白斑病	疾病
会阴下降综合征	疾病
老年无症状性心肌缺血	疾病
摄食	疾病
上尿路结石	疾病
晶体性关节炎	疾病
单纯糠疹	疾病
毛发上皮瘤	疾病
蓝舌病	疾病
精神抑郁症	疾病
棘颚口线虫病	疾病
恶性营养不良	疾病
老年肺栓塞	疾病
膈膨出和麻痹	疾病
考试综合症	疾病
急性牙髓炎	疾病
腹型偏头痛综合征	疾病
节日短信焦虑症	疾病
乙肝抗体	疾病
桃树黑星病	病毒
腋毛癣菌病	细菌
腋毛癣菌病	疾病
白菜类黑斑病	病毒
佛手瓜黑星病	病毒
高碘性甲状腺肿	疾病
精神空虚症	疾病
西瓜镰刀菌根腐病	病毒
茶芽枯病	疾病
溃疡性肠炎	疾病
红外线伤	疾病
铍病	疾病
烟草破烂叶斑病	病毒
花生网斑病	病毒
生殖道感染	疾病
苹果泡性溃疡病	病毒
茄子斑枯病	病毒
地方性呆小病	疾病
芹菜灰霉病	病毒
眼睑皮肤松弛综合征	疾病
骨感染病	疾病
埃立克体病	疾病
网络综合症	疾病
气瘿	疾病
抗菌药中毒性肾病	疾病
川崎症	疾病
假前综合症	疾病
西瓜褐腐病	病毒
溢乳闭经综合征	疾病
茄子煤斑病	病毒
菜用大豆斑驳病毒病	病毒
冬瓜褐斑病	病毒
猪蓝眼病	疾病
类艾滋病	病毒
类艾滋病	疾病
冬寒菜黑斑病	病毒
颌下腺导管结石	疾病
髓过氧化物酶缺乏症	疾病
毛细胞白血病	疾病
肺出血-肾炎综合征	疾病
梭状芽胞杆菌性肌坏死	疾病
蚕豆霜霉病	病毒
疯狂购物症	疾病
父爱饥渴症	疾病
手麻	疾病
心内膜炎	疾病
红线病	疾病
包涵体肌炎	疾病
XP病	疾病
急性重型肝炎	疾病
桃树轮纹病	病毒
镰状细胞性肾病	疾病
男性生殖系统结核	疾病
皮质白内障	疾病
噪声病	疾病
羊瘙痒症	疾病
上颌窦炎	疾病
二号病	疾病
胰腺多肽瘤	疾病
外照射亚急性放射病	疾病
油菜黑斑病	疾病
外周动脉病变	疾病
饮酒性精神障碍	疾病
肺诺卡菌病	疾病
幸存者综合症	疾病
职业医学	疾病
恋兽癖	疾病
骨髓抑制	疾病
老年消化性溃疡	疾病
持续性发热	疾病
热情恐惧症	疾病
克雷白杆菌肺炎	疾病
茶白纹羽病	疾病
小肠吸收不良综合征	疾病
汗疱疹	疾病
芫荽白粉病	病毒
混合性耳聋	疾病
说谎癖	疾病
化脓性脑膜脑炎	疾病
淋巴细胞减少症	疾病
电脑忧郁症	疾病
年关综合症	疾病
胡萝卜白绢病	病毒
微小膜壳绦虫病	疾病
心房间隔缺损	疾病
青霉素过敏	疾病
异形吸虫病	疾病
结节性脂膜炎	疾病
密切接触者	疾病
烟草低头黑病	病毒
囊状支气管扩张	疾病
颅内压增高综合症	疾病
周围神经病损	疾病
季节性情感障碍	疾病
曼氏裂头蚴病	疾病
犬瘟热病	疾病
不良建筑综合症	疾病
耻骨直肠肌综合征	疾病
慢性拖拉症	疾病
慢性充血性脾肿大	疾病
念珠菌性口炎	疾病
肝肉芽肿病	疾病
柑橘灰霉病	病毒
金瓜褐腐病	病毒
阴道毛滴虫	疾病
扁豆白绢病	病毒
老年脑萎缩	疾病
耳毒性耳聋	疾病
黄麻黑点炭疽病	病毒
杏仁中毒	疾病
慢性疲劳症候群	疾病
梨根朽病	病毒
软肋骨炎	疾病
职业性喉病	疾病
子宫内膜炎	疾病
获得性巨结肠	疾病
遗传性痉挛性共济失调	疾病
老年缺血性心肌病	疾病
大葱褐斑病	病毒
小儿消化性溃疡	疾病
甜菜白粉病	病毒
继发性心肌病	疾病
布卡综合征	疾病
猪坏死杆菌病	疾病
未闭动脉导管	疾病
念珠菌性心内膜炎	疾病
泡球蚴病	疾病
猪马铃薯中毒	疾病
淋巴肿瘤	疾病
类圆线虫病	疾病
黄麻枯腐病	病毒
创伤性心源性溶血性贫血	疾病
脓胸	疾病
臁疮	疾病
肾创伤	疾病
小儿支气管炎	疾病
妊娠合并弓形虫病	疾病
猪结核病	疾病
白宫综合症	疾病
莴苣穿孔病	病毒
狂躁症	疾病
囊肿型淋巴管瘤	疾病
家庭主妇综合征	疾病
腹膜后腔液体渗病	疾病
薹菜白锈病	病毒
小儿肺结核	疾病
光气中毒	疾病
牙关紧闭症	疾病
胃窦炎	疾病
更年期精神病	疾病
豇豆类菌原体丛枝病	疾病
神经外科	疾病
成人牙周炎	疾病
传导性失语症	疾病
胃粘膜上皮异型增生	疾病
脑旋毛虫病	疾病
童年孤独症	疾病
人生匆忙症	疾病
风湿骨病	疾病
慢性白血病	疾病
收缩性心力衰竭	疾病
坏死性筋膜炎	疾病
脱肛痔	疾病
枫糖尿病	疾病
内脏蠕虫蚴移行症	疾病
大颗粒淋巴细胞白血病	疾病
落葵苗腐病	病毒
急骤进行性肾小球肾炎	疾病
原发性肝内硬化综合征	疾病
薏苡黑穗病	病毒
冬瓜白粉病	病毒
猪水疱病	疾病
神经炎	疾病
先天性脑血管畸形	疾病
妊娠胆汁淤积症	疾病
甲基丙二酸尿症	疾病
纵火癖	疾病
家族聚集性乙肝	疾病
颅内动静脉畸形	疾病
微波治疗	疾病
苎麻褐斑病	病毒
肾功能	疾病
情感性障碍	疾病
猪传染性萎缩性鼻炎	疾病
胃空肠输入袢综合征	疾病
乳头状囊腺癌	疾病
高位截瘫	疾病
高血压眼病	疾病
结核性风湿症	疾病
不可复性盘前移位	疾病
黄瓜幼苗腐霉根腐病	病毒
息肉痔病	疾病
梨轮纹病	病毒
非典后遗症	疾病
隐性菌血症	疾病
弥漫性恶性间皮瘤	疾病
虚汗	疾病
乌塌菜黑斑病	病毒
鸭儿芹霜霉病	病毒
肛隐窝炎	疾病
回肠远端憩室	疾病
巨幼细胞性贫血	疾病
扁豆子叶和成株炭疽病	病毒
番茄果实牛眼腐病	病毒
慢性粘连性心包炎	疾病
人芽囊原虫病	疾病
口腔颌面部蜂窝织炎	疾病
心功能障碍	疾病
急性坏死性溃疡性龈炎	疾病
烫伤疤痕	疾病
心脏内粘液瘤	疾病
犬蛔虫病	疾病
缺铁性贫血症	疾病
妊娠性心肌梗死	疾病
青春期综合症	疾病
自发性食管破裂	疾病
单思病	疾病
大豆纹枯病	病毒
棉花黑根腐病	病毒
季节性抑郁症	疾病
急性左侧心力衰竭	疾病
发作性嗜睡强食症	疾病
维生素B缺乏症	疾病
柑橘疮痂病	病毒
新生儿贫血	疾病
早衰症	疾病
铁利用性贫血	疾病
丝瓜绵腐病	病毒
美丽强迫症	疾病
腹膜后间隙出血	疾病
亨丁顿舞蹈症	疾病
筛窦恶性肿瘤	疾病
神经管畸形	疾病
白领嗜贪症	疾病
曼氏血吸虫病	疾病
汉他病	疾病
儿茶酚氨症	疾病
对视恐怖症	疾病
感音神经性耳聋	疾病
小儿腹痛	疾病
胸主动脉动脉瘤	疾病
烟酸缺乏症	疾病
鼻源性颅内并发症	疾病
飞机恐惧症	疾病
特发性尿钙增多症	疾病
溴甲烷中毒	疾病
花粉过敏症	疾病
宫颈出血	疾病
扁豆黑斑病	病毒
煤油中毒	疾病
耳鼻咽喉梅毒	疾病
帕金森病	疾病
消化系统疾病	疾病
油菜白锈病	病毒
肺泡蛋白质沉积症	疾病
特发性心肌病	疾病
白菜类蔬菜黄叶病	病毒
单纯性牙周炎	疾病
甜菜苗腐病	病毒
sras	疾病
出血性脑梗死	疾病
甘蓝黄叶病	病毒
腹部疝	疾病
急性功能性子宫出血	疾病
发作性嗜睡病	疾病
wilson病	疾病
原卟啉病	疾病
不明原因肺炎	疾病
菠菜白锈病	病毒
选择性缄默症	疾病
新生儿坏死小肠结肠炎	疾病
低颅压性头痛	疾病
老年呼吸衰竭	疾病
叶酸代谢	疾病
共济失调毛细血管扩张症	疾病
周末焦虑症	疾病
癔病性失音	疾病
腹卒中综合征	疾病
猪附红细胞体病	疾病
巴瑞特综合征	疾病
产后肥胖症	疾病
竹红菌素	疾病
金瓜黑斑病	病毒
肌筋膜疼痛症	疾病
迁延性昏迷	疾病
胃泌素测定	疾病
毛孔角化症	疾病
书写痉挛症	疾病
婚后沉默症	疾病
盆腔淤血综合症	疾病
肛门潮湿	疾病
油菜苗期根腐病	病毒
肾上腺结核病	疾病
苦瓜白斑病	病毒
脂溢性皮肤炎	疾病
有机氮农药	疾病
转换性障碍	疾病
小儿丹毒	疾病
冷纤维蛋白原血症	疾病
糖脂病	疾病
烧伤全身性感染	疾病
外照射急性放射病	疾病
念珠菌症	疾病
筒线虫病	疾病
视力疲劳	疾病
学校恐怖症	疾病
消化道蠕虫病	疾病
落葵圆斑病	病毒
鸡白血病	疾病
苹果蝇粪病	病毒
内分泌浸润性突眼症	疾病
海绵窦血栓形成	疾病
遗传性周期性共济失调	疾病
遗传性代谢缺陷病	疾病
菜用大豆紫斑病	病毒
维生素b5	疾病
梨白绢病	病毒
豇豆褐斑病	病毒
生长障碍	疾病
穿腹膜疝	疾病
高锰酸钾中毒	疾病
慢性髓细胞白血病	疾病
四肢血栓性浅静脉炎	疾病
青少年性黄斑变性	疾病
苎麻角斑病	病毒
维生素B6	疾病
曲菌病	疾病
棘阿米巴角膜炎	疾病
蜱传回归热	疾病
白鼻综合征	疾病
耳鼻咽喉结核	疾病
涎腺的未分化癌	疾病
真菌败血症	疾病
鸡传染性贫血	疾病
贫血症	疾病
雪盲症	疾病
风湿热性心脏病	疾病
菜用大豆枯萎病	病毒
重舌	疾病
先天性主动脉缩窄	疾病
肝胆系统寄生虫病	疾病
肾周围炎	疾病
Reiter综合征	疾病
感染性甲沟炎	疾病
单纯肺动脉口狭窄	疾病
维生素B族	疾病
肩部撞击症	疾病
离退休综合症	疾病
美国式精神病	疾病
丙酮酸激酶缺乏症	疾病
爱情沉默症	疾病
耳源性颅内并发症	疾病
囊痈	疾病
物质依赖	疾病
甜椒白绢病	病毒
促性腺激素	疾病
维生素B1缺乏病	疾病
淋浊癃闭	疾病
视线恐惧症	疾病
慢性风湿性心脏病	疾病
十二指肠球部溃疡	疾病
日本脑炎	疾病
大肠埃希杆菌性胃肠炎	疾病
麻将病	疾病
茼蒿立枯病	病毒
慢性复发性腮腺炎	疾病
Lesch-Nyhan综合症	疾病
辛德毕斯病毒病	疾病
喉咽肿瘤	疾病
心内膜硬化症	疾病
急性小管间质性肾炎	疾病
慢性牙髓炎	疾病
拇囊炎	疾病
慢性放射病	疾病
急性或亚急性细菌性结膜炎	疾病
丘脑性闭经	疾病
节瓜细菌性角斑病	病毒
嘌呤代谢紊乱	疾病
棉花花叶病毒病	病毒
冷凝集素综合征	疾病
金瓜白粉病	病毒
现代办公职业病	疾病
感觉统合失调症	疾病
新生儿急性腹泻	疾病
小脑出血	疾病
豌豆尖镰刀菌萎凋病	病毒
龅牙	疾病
乌塌菜白斑病	病毒
移植排斥反应	疾病
感染性心肌炎	疾病
肝毛细线虫病	疾病
急性非特异性心包炎	疾病
春癣	疾病
密码强迫症	疾病
南瓜青霉病	病毒
前殖吸虫病	疾病
牙齿缺失	疾病
流行性腮腺炎性胰腺炎	疾病
柑橘黑斑病	病毒
疗程	疾病
脾功能亢进症	疾病
新月体性肾小球肾炎	疾病
慢性食管炎	疾病
猪水肿病	疾病
油菜白斑病	病毒
绕虫病	疾病
颅内炎症	疾病
烟草白绢病	病毒
紫外线伤	疾病
尿酸	疾病
西瓜丝核菌立枯病	病毒
豇豆灰霉病	病毒
过敏性荨麻疹	疾病
油菜炭疽病	病毒
大豆链格孢黑斑病	疾病
病毒性心肌炎后遗症	疾病
寡趣症	疾病
重叠类风湿性关节炎	疾病
猪维生素A缺乏症	疾病
滴虫	疾病
猪霉形体肺炎	疾病
唾液腺疾病	疾病
白淫	疾病
茄子果实疫病	病毒
广泛性发育障碍	疾病
腹膜后疝	疾病
蠕虫蚴移行症	疾病
穿透性心脏外伤	疾病
火疳	疾病
菜豆腐霉病	病毒
后天性免疫	疾病
黄斑部病变	疾病
四棱豆果腐病	病毒
少儿孤独症	疾病
乙型血友病	疾病
外耳道疖	疾病
东方马脑炎	疾病
心碎综合症	疾病
恐降症	疾病
潜在抑郁症	疾病
器官移植	疾病
肝病专科	疾病
疱症	疾病
盲肠炎	疾病
酒精肝检查	疾病
扁豆立枯病	病毒
高原心脏病	疾病
特发性间质性肺炎	疾病
春天综合症	疾病
桃花病	疾病
斑色鱼鳞癣	疾病
湿肺	疾病
失读症	疾病
芍药叶霉病	疾病
儿童学习障碍症	疾病
退变性关节炎	疾病
心包肌	疾病
脆性X染色体综合症	疾病
职场攀比症	疾病
疾病谱	疾病
苎麻炭疽病	病毒
急性脓胸	疾病
柑橘膏药病	病毒
躯体变形障碍症	疾病
番茄黑刺盘孢炭疽病	病毒
淋巴肉芽肿	疾病
梨褐斑病	病毒
扁豆花腐病	病毒
阿斯匹林不耐受三联症	疾病
皮疹	疾病
肠球菌败血症	疾病
大麻霉斑病	病毒
肛门直肠疾病	疾病
鸡卡氏白细胞原虫病	疾病
外照射慢性放射病	疾病
肾皮质髓质脓肿	疾病
快速进展性牙周炎	疾病
闭合性颅脑损伤	疾病
急黄	疾病
伴肿瘤的高钙血症	疾病
冬瓜绵腐病	病毒
高离氨基酸血症	疾病
恐人症	疾病
非伤寒沙门氏菌感染	疾病
稻田皮炎	疾病
急性肾上腺皮质功能减退症	疾病
眼囊尾蚴病	疾病
西方马脑炎	疾病
棉苗炭疽病	疾病
细粒棘球绦虫病	疾病
牙周脓肿	疾病
葡萄褐点病	病毒
biid	疾病
腰椎痛	疾病
甜瓜黑斑病	病毒
刀豆炭疽病	病毒
佯病症	疾病
化脓性腮腺炎	疾病
桑树芽枯病	病毒
失音	疾病
关怀强迫症	疾病
羞明怕热症	疾病
幼淋巴细胞白血病	疾病
先天性小耳及外耳道闭锁	疾病
脊柱	疾病
甜瓜果腐病	病毒
肾性骨病	疾病
枫糖尿症	疾病
便秘性结肠炎	疾病
急性间歇性卟啉病	疾病
卵巢黄体囊肿	疾病
狐惑	疾病
路怒症	疾病
graves眼病	疾病
多肽类抗生素	疾病
小儿低血糖症	疾病
淋巴滤泡	疾病
法氏囊	疾病
髓窦	疾病
疯牛病	病毒
疯牛病	疾病
致癌物	疾病
变应性接触性皮炎	疾病
绒毛膜促性腺激素	疾病
肿瘤转移	疾病
血液透析	疾病
三硝基甲苯	疾病
肉眼血尿	疾病
结晶尿	疾病
角膜	疾病
尿频	疾病
蛋白尿	疾病
尿痛	疾病
泌尿道感染	疾病
膀胱炎	疾病
植物神经	疾病
副交感神经	疾病
牙龈	疾病
烟民	疾病
二手烟	疾病
硬脑膜	疾病
高胆红素血症	疾病
锂盐	疾病
心血管系统	疾病
失明	疾病
神经衰弱综合征	疾病
膀胱	疾病
环氧化酶	疾病
病理学	疾病
皮肤粘膜淋巴结综合征	疾病
腐蚀性胃炎	疾病
胆道蛔虫病	疾病
深静脉血栓	疾病
凝血功能障碍	疾病
动静脉瘘	疾病
糖皮质激素	疾病
急性动脉栓塞	疾病
短暂性脑缺血	疾病
脊髓小脑性共济失调	疾病
喉头水肿	疾病
血栓性疾病	疾病
胃出血	疾病
体温调节中枢	疾病
过敏反应	疾病
水杨酸类	疾病
癌变	疾病
月经	疾病
呼吸功能衰竭	疾病
眼睑水肿	疾病
肾小球滤过率	疾病
组织水肿	疾病
急性肺水肿	疾病
脑疝	疾病
血压	疾病
脑瘤	疾病
前列腺	疾病
肾小球毛细血管	疾病
有毒气体	疾病
蛀牙	疾病
龋齿	疾病
呋喃型果糖	疾病
钾元素	疾病
中枢神经系统	疾病
支气管痉挛	疾病
谷丙转氨酶	疾病
白化症	疾病
甘油三脂	疾病
阻塞性黄疸	疾病
肥胖症	疾病
雄激素	疾病
哺乳	疾病
慢性病	疾病
瘦素	疾病
感染	细菌
感染	病毒
感染	疾病
排卵	疾病
受孕	疾病
血脂	疾病
初潮	疾病
维生素D	疾病
心血管	疾病
中毒性肺水肿	疾病
氯气中毒	疾病
呕吐	疾病
Kaposi肉瘤	疾病
咳嗽	疾病
恶心	疾病
肾上腺糖皮质激素	疾病
纵隔气肿	疾病
枯萎病	疾病
胃纳差	疾病
甲床	疾病
刺激性气体	疾病
特异性	疾病
二氧化碳分压	疾病
阴囊	疾病
室内空气污染物	疾病
血氨	疾病
尿糖	疾病
肝性昏迷	疾病
煤工尘肺	疾病
弱碱性	疾病
缺氧	疾病
水稻矮缩病	疾病
氰化物中毒	疾病
阿托品	疾病
酪酸	疾病
药物	疾病
酸蚀症	疾病
减压	疾病
疾病控制中心	疾病
慢性中毒	疾病
鱼病	疾病
汁液传染	疾病
水霉病	疾病
胆红素	疾病
微粒	疾病
氧中毒	疾病
氟代脱氧葡萄糖	疾病
正电子发射计算机断层扫描	疾病
杜氏利什曼原虫	疾病
弓形虫	疾病
螺旋体	疾病
阿米巴原虫	疾病
猪瘟	疾病
预防针	疾病
睡眠不足	疾病
免疫复合物	疾病
自身免疫性溶血性贫血	疾病
外源性哮喘	疾病
过敏性胃肠炎	疾病
病理反应	疾病
神经毒素	疾病
河豚毒	疾病
人用狂犬病疫苗	疾病
延髓	疾病
咽肌痉挛	疾病
蝎毒	疾病
IgG	疾病
助产士	疾病
寄生虫	疾病
描述流行病学	疾病
口蹄疫	疾病
病例对照研究	疾病
病人	疾病
恶性黑素瘤	疾病
不可逆性损伤	疾病
开放性损伤	疾病
筋结	疾病
腹膜刺激征	疾病
外感六淫	疾病
先天之精	疾病
损伤内证	疾病
痢疾	疾病
筋缩	疾病
脂肪代谢障碍	疾病
紫绀	疾病
外出血	疾病
血虚	疾病
钙超载	疾病
肋骨骨折	疾病
中间清醒期	疾病
慢性劳损	疾病
皮肤粘膜破损	疾病
肢节	疾病
血瘀	疾病
全身感染	疾病
筋伤	疾病
化脓性骨髓炎	疾病
硬膜外血肿	疾病
肌腱	疾病
肾脏损伤	疾病
筋痿	疾病
气滞血瘀	疾病
颅底骨折	疾病
心肺复苏术	疾病
碱性磷酸酶	疾病
伤筋	疾病
神经递质受体	疾病
I型超敏反应	疾病
Fas/FasL	疾病
牛瘟病	疾病
种痘	疾病
丝虫	疾病
人痘接种法	疾病
孕晚期	疾病
甲状旁腺	疾病
染色体异常	疾病
畸形精子	疾病
月经过多	疾病
垂体前叶	疾病
胚层分化	疾病
疟原虫	疾病
泌乳素	疾病
不育	疾病
卵泡	疾病
抗精子抗体	疾病
胚胎停育	疾病
高压氧	疾病
临床医学	疾病
LAK细胞	疾病
战壕热	疾病
毛细血管渗漏综合征	疾病
旁分泌	疾病
急性期反应	疾病
蠕虫感染	疾病
骨髓瘤	疾病
抗体检测	疾病
肿瘤发病率	疾病
小肠液	疾病
恙虫病立克次氏体	疾病
肿瘤细胞	疾病
淡斑	疾病
黑眼圈	疾病
睡眠时间	疾病
胸腺发育不全	疾病
过敏性疾病	疾病
低丙种球蛋白血症	疾病
传染性喉气管炎	疾病
绒毛膜上皮癌	疾病
细菌	细菌
艰难梭状芽胞杆菌	细菌
细菌耐药性	细菌
粘菌	细菌
乳球菌属	细菌
嗜麦芽窄食单胞菌	细菌
肺炎双球菌	细菌
变形杆菌	细菌
消炎药	细菌
广谱抗生素	细菌
链霉菌属	细菌
链孢囊菌属	细菌
放线菌属	细菌
天蓝色链霉菌	细菌
游动放线菌属	细菌
窄谱抗生素	细菌
超级细菌	细菌
颈腰腿痛贴	疾病
氨酚咖敏片	疾病
胸腺刺激素	疾病
裸盖菇素	疾病
氨基苷类抗生素	疾病
美替拉酮	疾病
穆氏本草	疾病
左卡尼丁注射液	疾病
艾滋病联合疫苗	病毒
艾滋病联合疫苗	疾病
阿司米星	疾病
伊达比星	疾病
心血管造影	疾病
占位性病变	疾病
造影剂肾病	疾病
尤文肉瘤	疾病
气管食管瘘	疾病
治疗诊断	疾病
肾病	疾病
占位效应	疾病
风寒湿痹	疾病
数字减影血管造影	疾病
肾血管性高血压	疾病
膀胱湿热证	疾病
环境医学监测	疾病
放射性核素成像	疾病
乳糜尿	疾病
造影	疾病
躯体化障碍	疾病
半卧位	疾病
腰穿检查	疾病
腰椎穿刺	疾病
脑萎缩	疾病
血管损伤	疾病
婚前检查	疾病
肿瘤免疫组织化学标记物	疾病
脑血管造影	疾病
肾上腺疾病	疾病
逆行胰胆管造影	疾病
肾脏损害	疾病
腹水	疾病
血管造影	疾病
尸体现象	疾病
脑血管痉挛	疾病
活体检查	疾病
胃镜	疾病
血栓性静脉炎	疾病
肺肿瘤	疾病
淋巴造影	疾病
脑干胶质瘤	疾病
高密度脂蛋白	疾病
精神病与精神卫生学	疾病
增强扫描	疾病
静脉肾盂造影	疾病
泌尿外科	疾病
内分泌科	疾病
神经内科	疾病
眼科	疾病
男科	疾病
精神科	疾病
肿瘤科	疾病
妇科	疾病
肾内科	疾病
外科	疾病
皮肤科	疾病
产科	疾病
流行性感冒病毒	病毒
流行性感冒病毒	疾病
脊髓灰质炎	疾病
锥体外系反应	疾病
舌炎	疾病
念珠菌病	疾病
泪腺	疾病
肾功能衰竭	疾病
慢性支气管炎	疾病
瑞氏综合征	疾病
肝功能不全	疾病
不稳定型心绞痛	疾病
急性风湿热	疾病
呼吸困难	疾病
格斯特曼综合症	疾病
低钠血症	疾病
急性肾小管坏死	疾病
慢性肾功能衰竭	疾病
脂肪泻	疾病
急性呼吸窘迫综合征	疾病
呼吸道炎症	疾病
四乙基铅	疾病
朊蛋白病	疾病
苯丙酮尿症	疾病
恶病质	疾病
先天性风疹	疾病
轮状病毒	病毒
轮状病毒	疾病
肾小球肾炎	疾病
风疹病毒	病毒
风疹病毒	疾病
继发性免疫缺陷病	疾病
尿毒症	疾病
骨痛	疾病
球孢子菌病	疾病
脑炎	疾病
慢性咳嗽	疾病
心功能不全	疾病
胸痛	疾病
库欣综合征	疾病
流行性斑疹伤寒	疾病
严重急性呼吸综合征	疾病
手足徐动症	疾病
致死性家族性失眠症	疾病
无动性缄默	疾病
中毒性休克综合征	疾病
传染性海绵状脑病	疾病
非洲猪瘟	疾病
进行性核上性麻痹	疾病
多系统萎缩	疾病
多发性硬化	疾病
常染色体隐性遗传	疾病
淋巴细胞脉络丛脑膜炎	疾病
角膜炎	疾病
戒酒综合征	疾病
满月脸	疾病
泌乳素瘤	疾病
产后大出血	疾病
闭经	疾病
新生儿呼吸窘迫综合征	疾病
旋毛虫病	疾病
低热	疾病
痈	疾病
食欲减退	疾病
肺嗜酸性粒细胞增多症	疾病
淋巴丝虫病	疾病
痴呆	疾病
低血糖症	疾病
门脉高压	疾病
先天性愚型	疾病
人粒细胞无形体病	疾病
汉坦病毒肺综合征	疾病
血精	疾病
头痛	疾病
带菌者	疾病
高氨血症	疾病
病态建筑综合征	疾病
黑蒙性家族痴呆症	疾病
潜伏梅毒	病毒
潜伏梅毒	疾病
急惊风	疾病
疫毒痢	疾病
慢惊风	疾病
肾毒性	疾病
头晕	疾病
肺燥咳嗽	疾病
噎膈	疾病
胆石	疾病
破水	疾病
先天性梅毒	疾病
前葡萄膜炎	疾病
蛛网膜下腔出血	疾病
脊髓灰质炎疫苗	疾病
脑震荡	疾病
绝经	疾病
鼻出血	疾病
血管运动性鼻炎	疾病
嘌呤代谢异常	疾病
生殖器念珠菌病	疾病
蓝氏贾第鞭毛虫病	疾病
粪类圆线虫病	疾病
华支睾吸虫病	疾病
淤胆型肝炎	疾病
腰痛	疾病
肠道寄生虫病	疾病
失语	疾病
关节疼痛	疾病
纳差	疾病
腰背部疼痛	疾病
感染性腹泻	疾病
出疹	疾病
社区获得性肺炎	疾病
大叶性肺炎	疾病
结核病	疾病
肺梗死	疾病
胆汁性肝硬化	疾病
肝昏迷	疾病
临床诊断	疾病
风疹	疾病
滤泡性结膜炎	疾病
脱敏	疾病
热原反应	细菌
热原反应	疾病
颅内压升高	疾病
胃病	疾病
神昏	疾病
胆管结石	疾病
钩端螺旋体病	疾病
智能发育不全	疾病
慢性膀胱炎	疾病
麻痹性痴呆	疾病
脑型肺吸虫病	疾病
脂蛋白血	疾病
脑梗塞	疾病
炭疽病	疾病
睑球粘连	疾病
肠功能紊乱	疾病
里急后重	疾病
中毒性菌痢	疾病
短肠综合征	疾病
吸收不良综合征	疾病
高磷血症	疾病
猪痘	疾病
脾脓肿	疾病
溶血性尿毒症综合征	疾病
心包炎	疾病
心源性休克	疾病
淋球菌	细菌
免疫缺陷病毒	疾病
白细胞减少症	疾病
胃液反流	疾病
戒断反应	疾病
预后	疾病
副溶血性弧菌	细菌
急性黄疸型肝炎	疾病
败血症	疾病
胁痛	疾病
肝风内动	疾病
植物状态	疾病
原发性血小板增多症	疾病
巨大血小板综合征	疾病
毛细血管扩张症	疾病
难治性贫血	疾病
慢性炎症性贫血	疾病
自身免疫性肝病	疾病
肺泡微结石症	疾病
酒精性脂肪肝	疾病
临床表现	疾病
冠状动脉瘤	疾病
腹痛	疾病
核黄疸	疾病
失盐性肾炎	疾病
过度通气	疾病
血虚风燥	疾病
猪流产	疾病
猪气喘病	疾病
脾囊肿	疾病
病毒性出血热	疾病
肾上腺皮质功能亢进	疾病
郁血性心脏衰竭	疾病
牙髓	疾病
先天性痴呆	疾病
冠状动脉痉挛	疾病
副溶血性弧菌食物中毒	疾病
假性痴呆	疾病
脑外伤后遗症	疾病
耳带状疱疹	病毒
耳带状疱疹	疾病
贫血病	疾病
库欣病	疾病
胃肠型食物中毒	疾病
肺火	疾病
乏力	疾病
息肉	疾病
先天性肾上腺增生症	疾病
胃动素	疾病
边缘系统	疾病
肠鸣	疾病
小儿乳糜泻	疾病
吸入性肺炎	疾病
脑动脉硬化症	疾病
小儿肾病	疾病
良性前列腺增生	疾病
21号染色体	疾病
先天性肾病综合征	疾病
间质性肾炎	疾病
多发性肌炎	疾病
肝移植排斥反应	疾病
原发性胆汁性肝硬化	疾病
妊娠中毒症	疾病
肾功能失调	疾病
冷凝集试验	疾病
暑热症	疾病
更年期妇女	疾病
三高	疾病
脑中风	疾病
亨廷顿病性痴呆	疾病
黑尿症	疾病
染色体病	疾病
小儿猫叫综合征	疾病
类癌	疾病
心源性哮喘	疾病
职业性哮喘	疾病
感觉障碍	疾病
小脑萎缩	疾病
月经来潮	疾病
抗心磷脂抗体	疾病
直立性低血压	疾病
一过性	疾病
急性胃扭转	疾病
胃肠道疾病	疾病
急性心包炎	疾病
胃肠道穿孔	疾病
肠痉挛	疾病
大网膜扭转	疾病
戒断症	疾病
中性粒细胞减少症	疾病
原发性痛经	疾病
痛觉	疾病
新生儿湿肺	疾病
库兴氏综合症	疾病
XYY	疾病
肠毛滴虫病	疾病
十二脂肠溃疡	疾病
艾滋病病毒感染者	疾病
风气内动	疾病
世界自闭症日	疾病
多发性神经病	疾病
秋燥	疾病
心肌缺氧	疾病
瓦登伯革氏症候群	疾病
霍纳综合征	疾病
慢性乙型病毒性肝炎	疾病
急性右心衰竭	疾病
上腔静脉综合征	疾病
急性肺栓塞	疾病
类鼻疽	疾病
十二指肠炎	疾病
赖特综合征	疾病
垂体卒中	疾病
高催乳素血症	疾病
松果体瘤	疾病
男性更年期	疾病
尿血红蛋白	疾病
咽结膜热	疾病
低烧	疾病
急性肝衰竭	疾病
金黄色葡萄球菌脑膜炎	疾病
时行感冒	疾病
连枷胸	疾病
更年期综合征	疾病
肺动脉栓塞	疾病
冠状病毒感染	疾病
副癌综合征	疾病
喘息性支气管炎	疾病
病态造血	疾病
深静脉血栓形成	疾病
代谢病	疾病
假性甲状旁腺功能减退	疾病
原发性乳腺恶性淋巴瘤	疾病
胸壁结核	疾病
横纹肌溶解综合征	疾病
筋膜间隙综合征	疾病
创伤性休克	疾病
MERS病毒	病毒
中东呼吸综合征	疾病
粘多糖沉积病	疾病
挤压综合征	疾病
军团菌病	疾病
宫颈息肉	疾病
卵巢功能早衰	疾病
席汉综合征	疾病
黄疸型肝炎	疾病
肝结核	疾病
打鼾	疾病
颞叶肿瘤	疾病
家族性结肠息肉	疾病
先天性肾上腺皮质增生症	疾病
手足麻木	疾病
卵巢过度刺激综合征	疾病
暴发性肝衰竭	疾病
子宫平滑肌瘤	疾病
风寒	疾病
黏液腺癌	疾病
乙酰胆碱	疾病
再灌注损伤	疾病
非特异性阴道炎	疾病
淋证	疾病
急性湿疹	疾病
婴儿腹泻	疾病
过期产儿	疾病
锰中毒	疾病
肠道肿瘤	疾病
痰热咳嗽	疾病
自发性脑室内出血	疾病
登革病毒	病毒
登革病毒	疾病
异位ACTH综合征	疾病
肾上腺皮质增生症	疾病
慢性肾上腺皮质功能减退症	疾病
纳尔逊综合征	疾病
老年人骨质疏松症	疾病
急性肝功能衰竭	疾病
三焦辨证	疾病
生殖器结核	疾病
产褥期抑郁症	疾病
经前期综合征	疾病
外阴鳞状上皮细胞增生	疾病
出生缺陷	疾病
脑性瘫痪综合征	疾病
湿热下注	疾病
气虚便秘	疾病
膀胱湿热	疾病
恶寒	疾病
右下腹痛	疾病
产后恶露不绝	疾病
暴饮暴食	疾病
高热	疾病
痉病	疾病
痔瘘	疾病
血管活性肠肽瘤	疾病
临床思维	疾病
慢性疲劳综合征	疾病
急性应激反应	疾病
心境障碍	疾病
神经系统遗传性疾病	疾病
半乳糖血症	疾病
电生理检查	疾病
脊髓半切综合征	疾病
脊柱肿瘤	疾病
脑桥中央髓鞘溶解症	疾病
腓骨肌萎缩	疾病
肺动脉瓣狭窄	疾病
21一三体综合征	疾病
幼年类风湿关节炎	疾病
心包疾病	疾病
噬血细胞综合征	疾病
儿童行为问题	疾病
胎粪吸入综合征	疾病
小儿肾小球疾病	疾病
急性感染性多发性神经根炎	疾病
溶血性尿毒综合征	疾病
再生障碍性贫血	疾病
膀胱输尿管反流	疾病
急性颅内压增高	疾病
腹腔间隔室综合征	疾病
硬脑膜下血肿	疾病
多器官功能障碍综合征	疾病
酒精所致精神障碍	疾病
结肠易激综合征	疾病
脑动脉硬化	疾病
CRF	疾病
全身适应综合征	疾病
肺炎支原体	疾病
疑难病	疾病
癌性胸腹水	疾病
三尖瓣返流	疾病
无症状性脑梗死	疾病
原发性视网膜色素变性	疾病
智能低下	疾病
血小板增多症	疾病
外痔	疾病
手足心热	疾病
水火烫伤	疾病
尿道综合症	细菌
尿道综合症	疾病
硒中毒	疾病
尿路刺激征	疾病
口腔粘膜病	疾病
甲状腺危象	疾病
完全性房室传导阻滞	疾病
高血压脑病	疾病
病理科	疾病
经行泄泻	疾病
经行发热	疾病
抑郁发作	疾病
遗忘综合征	疾病
精神科综合征	疾病
结节病	疾病
孤独症	疾病
关节强直	疾病
带下	疾病
胁肋痛	疾病
复热	疾病
春温	疾病
夏季感冒	疾病
小儿变蒸	疾病
多发性抽动症	疾病
痹病	疾病
风为百病之长	疾病
夏季热	疾病
胎黄	疾病
新生儿硬肿症	疾病
电脑病	疾病
肝火旺盛	疾病
疯牛病病毒	病毒
裂沟舌	疾病
发颐	疾病
前斜角肌综合征	疾病
血管性头痛	疾病
臌胀	疾病
五善七恶	疾病
证候	疾病
乌头碱	疾病
黑色素瘤	疾病
闭经溢乳综合征	疾病
盆腔瘀血综合征	疾病
瘿瘤	疾病
膀胱疼痛综合征	疾病
脓痰	疾病
耳眩晕	疾病
肿胀	疾病
阴盛格阳	疾病
重叠综合征	疾病
临床营养	疾病
急性骨髓炎	疾病
梨状肌综合征	疾病
桡骨茎突狭窄性腱鞘炎	疾病
痹证	疾病
脾病	疾病
淀粉样变性	疾病
分离症状	疾病
心脏神经官能症	疾病
临床治愈	疾病
碘过敏试验	疾病
亚临床肝癌	疾病
神经性肠梗阻综合征	疾病
卵巢纤维瘤	疾病
卵泡黄素化	疾病
羊膜穿刺	疾病
脆性X染色体综合征	疾病
Prader-Willi综合征	疾病
先天性甲状腺功能低下	疾病
睾丸女性化综合征	疾病
共济失调症	疾病
肺部良性肿瘤	疾病
小儿类风湿病	疾病
肝肺综合征	疾病
重金属中毒性肾病	疾病
急进性肾炎	疾病
干咳	疾病
Pancoast综合征	疾病
肥大性骨关节病	疾病
单纯性紫癜	疾病
继发性血小板减少症	疾病
先天性肺囊肿	疾病
Kartagener综合征	疾病
经行情志异常	疾病
细菌性痢疾	疾病
膜性肾小球肾炎	疾病
耳鸣耳聋	疾病
前列腺增生肥大	疾病
耳咽管	疾病
前庭神经元炎	疾病
Fanconi综合征	疾病
宫腔粘连	疾病
盆腔静脉曲张	疾病
原发性肺结核	疾病
急性粟粒型肺结核	疾病
浸润型肺结核	疾病
脑转耳鸣	疾病
外劳宫	疾病
先天性膈疝	疾病
恶性畸胎瘤	疾病
边缘型人格障碍	疾病
筋膜间隔区综合征	疾病
桡骨头骨折	疾病
精浊	疾病
胃黏膜脱垂	疾病
蛋白质营养不良	疾病
活动性肺结核	疾病
露阴癖	疾病
心音异常	疾病
尿隐血	疾病
小肠细菌过度生长	疾病
肝衰竭	疾病
糖尿病皮肤病变	疾病
皮肤擦伤	疾病
维生素D中毒	疾病
肌束震颤	疾病
复合性溃疡	疾病
异位性心动过速	疾病
手足搐搦症	疾病
低血钙	疾病
常染色体显性遗传	疾病
军团菌	细菌
子宫颈	疾病
甲状腺素	疾病
中枢神经系统症状	疾病
人类免疫缺陷病毒	病毒
人类免疫缺陷病毒	疾病
过敏	疾病
镰状细胞贫血	疾病
朊病毒	疾病
口蹄疫病毒	病毒
口蹄疫病毒	疾病
Virus	病毒
虫媒病毒	疾病
流行性乙型脑炎病毒	病毒
流行性乙型脑炎病毒	疾病
巨细胞病毒	病毒
巨细胞病毒	疾病
流感病毒性肺炎	疾病
腮腺炎病毒	病毒
腮腺炎病毒	疾病
麻疹病毒	病毒
麻疹病毒	疾病
血凝抑制抗体	病毒
弹状病毒	病毒
弹状病毒科	病毒
SV40	病毒
芜菁花叶病毒	病毒
黄瓜花叶病毒	病毒
呼吸道合胞病毒	病毒
呼吸道合胞病毒	疾病
正粘病毒科	病毒
SIV	病毒
流感病毒肺炎	疾病
禽流感病毒	病毒
禽流感病毒	疾病
H7N9型禽流感	病毒
单纯疱疹病毒性脑炎	疾病
EB病毒	细菌
EB病毒	疾病
RNA病毒	病毒
RNA病毒	疾病
疱疹病毒科	疾病
人乳头瘤病毒	病毒
人乳头瘤病毒	疾病
复制中间体	病毒
副粘病毒	病毒
马铃薯Y病毒科	病毒
百合无症病毒	病毒
百合无症病毒	疾病
抗病毒	疾病
病毒性肺炎	疾病
衣壳粒	病毒
花叶病毒	病毒
乙型肝炎病毒	病毒
乙型肝炎病毒	疾病
质型多角体病毒	病毒
小DNA病毒科	病毒
家蚕软化病病毒	病毒
核型多角体病毒	病毒
颗粒体病毒	病毒
毒粒	病毒
埃可病毒	疾病
冠状病毒	病毒
冠状病毒	疾病
杀毒软件	病毒
木马病毒	病毒
乙型病毒性肝炎	疾病
CIH病毒	病毒
米尔	病毒
汉坦病毒	病毒
汉坦病毒	疾病
布尼亚病毒科	病毒
独特	病毒
网络病毒	病毒
恶意程序	病毒
黑客	病毒
灰霉病	病毒
诺如病毒	病毒
诺如病毒	疾病
狂犬病毒	病毒
狂犬病毒	疾病
假病毒	病毒
慢病毒	病毒
炭疽病毒	疾病
甘薯羽状斑驳病毒	病毒
小西葫芦黄花叶病毒	病毒
李痘病毒	病毒
豌豆种传花叶病毒	病毒
肝炎病毒	病毒
肝炎病毒	疾病
黑麦草花叶病毒属	病毒
大麦黄花叶病毒属	病毒
抗原性转变	病毒
肠道病毒感染	病毒
肠道病毒感染	疾病
黄病毒	病毒
黄病毒	疾病
西尼罗病毒病	疾病
柯萨奇病毒A16型	病毒
柯萨奇病毒A16型	疾病
肠道病毒71型	病毒
肠道病毒71型	疾病
肉毒杆菌毒素	病毒
轮状病毒疫苗	病毒
轮状病毒疫苗	疾病
急性病毒性肝炎	疾病
病毒性结膜炎	疾病
莫德	病毒
猪流感病毒	病毒
猪流感病毒	疾病
柯萨奇病毒感染	疾病
病毒性感冒	病毒
病毒性感冒	疾病
甲型肝炎病毒	病毒
甲型肝炎病毒	疾病
T病毒	疾病
魔之卡组破坏病毒	病毒
细小病毒	病毒
细小病毒	疾病
微生物培养	病毒
文件型病毒	病毒
回旋木马	病毒
乙型流感病毒	病毒
人乳头状瘤病毒	病毒
人乳头状瘤病毒	疾病
小RNA病毒	病毒
肠病毒	病毒
肠病毒	疾病
杀菌农药	细菌
杀菌农药	病毒
抗病毒药物	疾病
丝状病毒	病毒
抗病毒治疗	疾病
乙肝病毒脱氧核糖核酸	疾病
巴氏消毒	病毒
抗生菌	细菌
抗生菌	病毒
抗原性漂移	病毒
小RNA病毒科	病毒
小RNA病毒科	疾病
腺病毒感染	疾病
病毒粒体	病毒
生物化学药	病毒
第四级病毒	病毒
第四级病毒	疾病
埃博拉病毒	疾病
番茄不孕病毒	病毒
黑洞	病毒
H2N2	病毒
植物病毒	病毒
病毒性感染	病毒
病毒性感染	疾病
流氓软件	病毒
批处理	病毒
黄鑫	病毒
犬细小病毒病	疾病
兼性厌氧细菌	细菌
兼性厌氧细菌	病毒
戊型肝炎病毒	病毒
戊型肝炎病毒	疾病
病毒性呼吸道感染	疾病
病毒性上呼吸道感染	疾病
病毒性角膜炎	疾病
甲型流感病毒	病毒
甲型流感病毒	疾病
重组逆转录病毒	疾病
脑心肌炎病毒	病毒
脑心肌炎病毒	疾病
条件缺损病毒	病毒
鸭肝炎病毒	病毒
猪脑脊髓炎病毒	病毒
乳头瘤病毒	病毒
乳头瘤病毒	疾病
病毒包膜	病毒
无症状乙肝病毒携带者	疾病
疱疹病毒性脑炎	疾病
助体病毒	病毒
毒株	病毒
脊椎动物病毒	病毒
脊椎动物病毒	疾病
水稻病毒属	病毒
新城疫病毒	病毒
新城疫病毒	疾病
斐济病毒属	病毒
植物呼肠孤病毒属	病毒
ECHO病毒	病毒
人类乳头瘤病毒	病毒
人类乳头瘤病毒	疾病
慢病毒感染	疾病
达克	病毒
VirusTotal	病毒
朊病毒病	疾病
病毒包装	疾病
我的电脑	病毒
蠕虫病毒	病毒
甘蔗黄锈病	病毒
Caligula	病毒
苹果树腐烂病	病毒
黑斑蚊	病毒
诺沃克	病毒
病毒性神经坏死病	疾病
疱疹病毒	病毒
疱疹病毒	疾病
乙型肝炎病毒相关性肾炎	疾病
慢性病毒感染	疾病
香港病毒	病毒
番茄环斑病毒	病毒
番茄环斑病毒	疾病
圣诞CIH病毒	病毒
引导型病毒	病毒
SSDT	病毒
博尔纳病毒	病毒
博尔纳病毒	疾病
扁豆细菌性疫病	病毒
艾滋病毒	病毒
艾滋病毒	疾病
恶鹰变种	病毒
菜豆金色花叶病毒属	病毒
茶树紫纹羽病	病毒
尖峰洞变种	病毒
汉江病毒	病毒
汉江病毒	疾病
转座病毒科	病毒
大葱、洋葱褐斑病	病毒
疯牛病毒	病毒
疯牛病毒	疾病
玉米线条病毒属	病毒
甘薯丛枝病	病毒
雀麦花叶病毒	病毒
求职信变种病毒	病毒
梨炭疽病	病毒
斑疹伤寒病毒	病毒
斑疹伤寒病毒	疾病
蚕豆染色病毒	病毒
Nimda病毒	病毒
甜椒、辣椒	病毒
甲型H3流感	病毒
甲型H3流感	疾病
化脓性脑炎病毒	病毒
化脓性脑炎病毒	疾病
双生病毒科	病毒
Marseillevirus	病毒
多分体基因组	病毒
芫荽、香芹株腐病	病毒
安天实验室	病毒
芜菁黄花叶病毒属	病毒
卤猪病毒	病毒
肾综合征出血热病毒	病毒
肾综合征出血热病毒	疾病
花椰菜花叶病毒	病毒
烟草环斑病毒病	细菌
亨德拉病毒	病毒
亨德拉病毒	疾病
小麦蓝矮病毒病	病毒
植物病毒病	疾病
大葱、洋葱黑粉病	病毒
绿豆病毒病	病毒
扁豆花叶病毒病	病毒
番茄黑环病毒	病毒
冬瓜、节瓜菌核病	病毒
棉茎枯病	病毒
艾克蠕虫	病毒
顾氏小体	病毒
大豆矮缩病毒	病毒
大蒜褪绿条斑病毒病	病毒
烟草脆裂病毒	病毒
D型艾滋病病毒	病毒
D型艾滋病病毒	疾病
小邮差变种I	病毒
花椰菜花叶病毒属	病毒
花椰菜花叶病毒科	病毒
腺病毒55型	病毒
腺病毒55型	疾病
曲顶病毒属	病毒
亚病毒	病毒
烟草花叶病毒	病毒
郁金香碎色病毒	病毒
二十面体	病毒
前病毒	病毒
黄热病病毒	病毒
黄热病病毒	疾病
计算机病毒	病毒
RNA肿瘤病毒	病毒
RNA肿瘤病毒	疾病
肉瘤病毒	病毒
溶原性噬菌体	病毒
蜱虫	病毒
类病毒	病毒
天花病毒	病毒
天花病毒	疾病
网络安全	病毒
真病毒	病毒
椰子死亡类病毒	病毒
衣壳	病毒
鳄梨日斑类病毒	病毒
马铃薯Y病毒属	病毒
西尼罗病毒	病毒
西尼罗病毒	疾病
DNA病毒	病毒
莴苣花叶病毒	病毒
山羊痘病毒	病毒
病毒感染	疾病
丁型肝炎病毒	病毒
丁型肝炎病毒	疾病
核衣壳	病毒
Y病毒	病毒
病毒入侵	病毒
野兔热杆菌	细菌
野兔热杆菌	病毒
囊膜	病毒
病毒血症	病毒
病毒血症	疾病
乙肝病毒耐药	病毒
痘病毒	病毒
痘病毒	疾病
马尔堡病毒	病毒
马尔堡病毒	疾病
口疮病毒属	病毒
巨细胞病毒感染症	疾病
埃博拉病毒	病毒
埃博拉病毒	疾病
丙型病毒性肝炎	病毒
水痘-带状疱疹病毒	病毒
水痘-带状疱疹病毒	疾病
亚洲流感	病毒
包含体	病毒
复制型	病毒
丙型肝炎病毒	病毒
丙型肝炎病毒	疾病
拟病毒	病毒
甲型H1N1流感病毒	病毒
甲型H1N1流感病毒	疾病
反转录病毒	病毒
动物病毒	病毒
狂犬病病毒	病毒
狂犬病病毒	疾病
多瘤病毒	病毒
基因整合	病毒
肠道病毒属	病毒
心病毒属	病毒
壳粒	病毒
柯萨奇病毒	病毒
柯萨奇病毒	疾病
生物病毒	病毒
猪水疱疹病毒	病毒
猪水疱疹病毒	疾病
正粘病毒	病毒
正粘病毒	疾病
猪水疱病病毒	病毒
鼻病毒	病毒
鼻病毒	疾病
鸡脑脊髓炎病毒	病毒
病毒结构	病毒
埃柯病毒	病毒
单纯疱疹病毒	病毒
单纯疱疹病毒	疾病
囊膜病毒	病毒
呼肠孤病毒科	病毒
脊髓灰质炎病毒	病毒
脊髓灰质炎病毒	疾病
呼肠孤病毒	病毒
呼肠孤病毒	疾病
猪瘟病毒	病毒
猪瘟病毒	疾病
肠道病毒	疾病
人巨细胞病毒	病毒
仙台病毒	病毒
杆状病毒	病毒
腺病毒	疾病
重组杆状病毒	病毒
溴化乙锭	病毒
滤过性病毒	病毒
滤过性病毒	疾病
