热微菌门	细菌
产金菌门	细菌
梭杆菌门	细菌
放线菌门	细菌
疣微菌门	细菌
衣原体门	细菌
脱铁杆菌门	细菌
热脱硫杆菌门	细菌
酸杆菌门	细菌
葡萄球菌性食物中毒	疾病
自生固氮菌	细菌
T2噬菌体	病毒
滑行细菌	细菌
荚膜组织胞浆菌病	疾病
微需氧菌	细菌
化能合成细菌	细菌
耐甲氧西林金黄色葡萄球菌	细菌
口腔念珠菌病	疾病
壶菌病	疾病
真菌性皮肤病	疾病
蛭弧菌	细菌
细菌性食物中毒	疾病
军团菌肺炎	疾病
氢细菌	细菌
内生菌	细菌
土拉杆菌病	疾病
链球菌咽喉炎	疾病
链球菌	细菌
舌菌	疾病
甲烷杆菌	细菌
细菌性脑膜炎	疾病
肉毒杆菌	细菌
一般反应	症状
机会性感染	疾病
自身免疫疾病	疾病
寄生虫病	疾病
红斑狼疮	疾病
并发症	疾病
人流感	疾病
动脉硬化	疾病
生殖器疱疹	疾病
尖锐湿疣	疾病
脑血管疾病	疾病
疱疹	疾病
性功能	疾病
立克次体痘	疾病
网膜炎	疾病
莱姆病	疾病
急性鼻炎	疾病
肾炎	疾病
肛周脓肿	疾病
猫白血病	疾病
食物中毒	疾病
附睾炎	疾病
软下疳	疾病
一期梅毒	症状
皮肤溃疡	疾病
落矶山斑点热	疾病
职业病	疾病
可的松	疾病
百白破三联疫苗	疾病
新生儿败血症	疾病
骨炎	疾病
心脏病	疾病
高热惊厥	疾病
晕动病	疾病
胸痹	疾病
牙周病	疾病
病原携带者	症状
骨瘤	疾病
掌跖脓疱病	疾病
粘膜白斑	疾病
巩膜炎	疾病
中暑	疾病
大动脉炎	疾病
脓疱病	疾病
钩虫病	疾病
萎缩性鼻炎	疾病
常年性鼻炎	症状
外阴瘙痒	症状
溃疡性结肠炎	疾病
克罗恩病	疾病
脘腹胀满	症状
淋病	疾病
冬病夏治	疾病
猪流行性感冒	疾病
慢性肝炎	病毒
重型肝炎	疾病
蛲虫病	疾病
嗜睡	疾病
盆腔脓肿	疾病
鱼鳞病	疾病
结节性红斑	疾病
西尼罗河热	疾病
脑膜脑炎	疾病
纵隔肿瘤	疾病
人畜共患病	疾病
特殊检查	疾病
鼻硬结	症状
烧心	症状
感冒发烧	症状
器质性	疾病
梅尼埃病	疾病
痒疹	疾病
过敏性哮喘	疾病
囊肿性纤维化	疾病
食源性疾病	疾病
黄胆	症状
坏血病	疾病
外科感染	疾病
慢性间质性肾炎	疾病
脱髓鞘	疾病
脱髓鞘病	疾病
铁缺乏症	疾病
泪道阻塞	疾病
沙眼衣原体	疾病
鸽痘	疾病
狼疮性脂膜炎	疾病
肾下垂	症状
营养性贫血	疾病
减压病	疾病
蝇蛆病	疾病
猪传染性胸膜肺炎	疾病
急性膀胱炎	疾病
免疫缺陷综合症	病毒
糖原累积病	疾病
AZT	药物
咳喘	症状
脑动脉炎	疾病
僵猪	疾病
狐惑病	疾病
闭塞性动脉硬化症	疾病
高尿酸	疾病
血尿	症状
血小板疾病	疾病
增生性贫血	疾病
重大疾病	疾病
衣原体感染	疾病
囊虫病	疾病
前列环素	疾病
风热乳蛾	症状
自闭症	疾病
心脑血管疾病	疾病
马尔堡出血热	疾病
禽霍乱	疾病
牙齿保健	疾病
水俣病	疾病
胃阴亏虚	疾病
粘膜病	疾病
消谷善饥	症状
肋间神经痛	症状
急性肠炎	疾病
瘙痒	症状
甲状旁腺疾病	疾病
乳腺疾病	疾病
面部色斑	疾病
甲状旁腺功能亢进症	疾病
皮肤肿瘤	疾病
铁粒幼细胞性贫血	疾病
肠胀气	症状
胆道结石	疾病
器质性疾病	疾病
熬夜	疾病
狼疮性肾炎	疾病
妊娠毒血症	疾病
心肌病	疾病
肝囊肿	疾病
急性肾盂肾炎	疾病
腹胀	症状
感染性疾病	疾病
分泌性中耳炎	疾病
慢性阻塞性肺疾病	疾病
自身免疫性肝炎	疾病
组织反应	疾病
缺血性坏死	疾病
脓皮症	疾病
心慌气短	症状
恶心	症状
四肢麻木	症状
脉学	疾病
头风病	疾病
功能性疾病	症状
诈病	疾病
消化不良	疾病
思维障碍	症状
囊肿	疾病
手脚发麻	症状
网状细胞肉瘤	疾病
色素减退	疾病
脊柱侧凸	疾病
男性乳腺发育症	疾病
病理诊断	疾病
肾小球疾病	疾病
肾静脉血栓形成	疾病
中度贫血	症状
下肢瘫痪	疾病
乳头溢液	症状
乳腺导管扩张症	疾病
恶性组织细胞病	疾病
微孢子虫病	疾病
遗传病	疾病
消渴症	症状
哮喘	症状
便秘	症状
耳硬化症	疾病
下肢静脉血栓	疾病
空气栓塞	疾病
肺间质纤维化	疾病
囊性纤维化	疾病
细胞周期特异性药物	药物
白秃疮	疾病
急性光气中毒	疾病
缺氧症状	症状
寄生胎	疾病
肛门坠胀	症状
阳性体征	疾病
急性伤害	症状
癌前疾病	疾病
主诉	症状
扁桃体肿大	疾病
胎儿窘迫	症状
手机依赖症	疾病
吐酸	症状
气淋	疾病
热盛伤津	疾病
湿热内盛	症状
皮肤松弛症	症状
中枢神经系统脱髓鞘疾病	疾病
脊椎病	症状
神经皮肤综合征	疾病
后侧索联合变性	疾病
枕大神经痛	疾病
分离性感觉障碍	症状
心肌疾病	疾病
新生儿窒息	疾病
IgA肾病	疾病
锌缺乏症	症状
感染性皮肤病	疾病
尿石症	疾病
少年白	疾病
椎间盘变性	症状
主动脉瓣钙化	症状
黄斑囊样水肿	疾病
虹视	症状
角膜变性	疾病
中枢性面瘫	疾病
尿滴沥	症状
慢性宫颈炎	疾病
遗传代谢病	疾病
感染性阴道炎	疾病
急迫性尿失禁	症状
衣原体病	疾病
风湿病	疾病
大便带血	症状
胸外科	医学专科
牙齿感觉过敏症	症状
牙齿磨损	疾病
精神官能症	疾病
频尿	症状
H1N1	病毒
疱疹性口炎	疾病
停经	症状
轻躁狂	症状
肥大细胞增多症	症状
血管性血友病	疾病
多发性脑梗塞	疾病
脑缺血性疾病	疾病
药物滥用	药物
脑梗塞后遗症	症状
慢性滑膜炎	疾病
原发性肾小球肾炎	疾病
下膈	疾病
梅毒	疾病
奶麻	疾病
小儿暑温	疾病
慢性浅表性胃炎	疾病
遗传缺陷	疾病
心律失常	疾病
持续性感染	病毒
情志病	疾病
药物治疗	疾病
月经提前	症状
自身免疫性疾病	疾病
痿症	疾病
腹泻便血	症状
常染色体病	疾病
Burkitt淋巴瘤	病毒
黏多糖贮积症	疾病
食管损伤	疾病
化疗药物	药物
口腔白斑病	疾病
脑囊虫病	疾病
放射病	疾病
梗阻性肾病	疾病
血管性紫癜	疾病
输卵管不通	疾病
糖尿病	疾病
暴食症	疾病
饮食紊乱	疾病
漏斗胸	疾病
踝关节扭伤	疾病
肿块	疾病
雷诺病	疾病
骨质软化症	疾病
利什曼原虫病	疾病
高脂血症	疾病
睾丸肿胀	疾病
隐匿阴茎	疾病
弹性假黄瘤	疾病
骨软骨病	疾病
营养缺乏病	疾病
NCD	疾病
获得性面部皮肤衰老症	疾病
传染病	疾病
急性丁型肝炎	疾病
非结核分枝杆菌肺病	疾病
网状青斑症	疾病
斯特格病	疾病
老年无症状性心肌缺血	症状
考试综合症	症状
铍病	疾病
气瘿	疾病
抗菌药中毒性肾病	疾病
心内膜炎	疾病
噪声病	疾病
汗疱疹	疾病
胆囊炎	疾病
说谎癖	疾病
肝肉芽肿病	疾病
职业性喉病	症状
腹膜炎	疾病
类圆线虫病	疾病
神经外科	疾病
慢性白血病	疾病
结核性风湿症	疾病
特发性尿钙增多症	疾病
新生儿坏死小肠结肠炎	疾病
书写痉挛症	疾病
肛门潮湿	症状
冷纤维蛋白原血症	疾病
学校恐怖症	疾病
囊痈	疾病
拇囊炎	疾病
慢性放射病	疾病
冷凝集素综合征	疾病
密码强迫症	疾病
蠕虫蚴移行症	疾病
乳腺炎	疾病
湿肺	疾病
苎麻炭疽病	疾病
肛门直肠疾病	疾病
外照射慢性放射病	疾病
血栓闭塞性脉管炎	疾病
便秘性结肠炎	疾病
深静脉血栓	疾病
血脂异常	疾病
组织水肿	症状
脑疝	药物
氯气中毒	疾病
白血病	疾病
免疫复合物	细菌
淡斑	疾病
地塞米松	症状
乳球菌属	细菌
风湿热	疾病
药品	疾病
失荣	疾病
强力霉素	药物
同化激素	药物
扎鲁司特	药物
赖诺普利	药物
氮芥	药物
钙铁锌硒片	药物
百忧解20	药物
otc	药物
解热镇痛抗炎药	药物
肽类抗生素	药物
胃息肉	症状
躯体化障碍	疾病
脊髓灰质炎	病毒
抗炎药	药物
朊蛋白病	疾病
风疹病毒	病毒
吞咽困难	症状
心功能不全	症状
口干	症状
致死性家族性失眠症	疾病
传染性海绵状脑病	疾病
泌乳素瘤	疾病
贫血	症状
食欲减退	症状
胰腺炎	疾病
利尿剂	药物
腰椎间盘突出症	症状
噎膈	疾病
主动脉夹层动脉瘤	疾病
出疹	症状
胆汁性肝硬化	疾病
麻痹性痴呆	症状
脑型肺吸虫病	疾病
室性期前收缩	症状
副溶血性弧菌	细菌
结缔组织病	疾病
酒精性脂肪肝	疾病
核黄疸	疾病
失盐性肾炎	疾病
过度通气	症状
病毒性出血热	疾病
绒毛活检	疾病
多发性肌炎	疾病
肝血管瘤	症状
暑热症	疾病
慢性腹泻	症状
脑中风	疾病
类癌	疾病
前列腺疾病	疾病
身体依赖性	症状
艾滋病病毒感染者	病毒
秋燥	疾病
类鼻疽	疾病
HIV病毒	病毒
心肌炎	疾病
深静脉血栓形成	症状
假性甲状旁腺功能减退	疾病
胸壁结核	疾病
粘多糖沉积病	症状
淋巴瘤	症状
手足麻木	疾病
生殖器结核	疾病
产褥期抑郁症	症状
经前期综合征	疾病
奴佛卡因	药物
心包疾病	疾病
小儿肾小球疾病	疾病
血小板增多症	疾病
手足心热	症状
尿道综合征	症状
结节病	疾病
夏季热	疾病
胸廓出口综合征	症状
梨状肌综合征	疾病
桡骨茎突狭窄性腱鞘炎	症状
纳减	症状
Fanconi综合征	疾病
精浊	疾病
低血钙	症状
常染色体显性遗传	疾病
毒性弥漫性甲状腺肿	疾病
心绞痛	症状
呼吸道合胞病毒	病毒
流感病毒肺炎	疾病
H7N9型禽流感	病毒
人乳头瘤病毒	病毒
花叶病毒	病毒
家蚕软化病病毒	病毒
CIH病毒	病毒
假病毒	病毒
病毒性感冒	疾病
细小病毒	病毒
病毒性心肌炎	疾病
条件缺损病毒	病毒
毒株	病毒
蠕虫病毒	病毒
花椰菜花叶病毒	病毒
亨德拉病毒	病毒
腺病毒55型	病毒
亚病毒	病毒
病毒入侵	病毒
埃博拉病毒	病毒
正粘病毒	病毒
呼肠孤病毒	病毒
杆状病毒	病毒
